Date,GF-Ferjeleia,GF-Glasshytta,GF-Isegran,GF-Kasernen,GF-Laboratoriegaten,GF-Magenta,GF-Mormors,GF-Pumpehuset,Totalt
2018-10-01 00:00:00,11,11,0,0,0,11,0,0,33
2018-10-01 01:00:00,0,0,0,0,0,11,0,0,11
2018-10-01 02:00:00,0,11,0,0,0,11,0,0,22
2018-10-01 03:00:00,0,0,0,0,0,0,0,0,0
2018-10-01 04:00:00,11,0,0,0,0,0,0,0,11
2018-10-01 05:00:00,23,0,0,0,0,0,0,0,23
2018-10-01 06:00:00,59,0,0,0,0,0,0,0,59
2018-10-01 07:00:00,118,0,0,0,0,11,0,0,129
2018-10-01 08:00:00,200,35,0,0,47,23,0,82,387
2018-10-01 09:00:00,94,23,0,0,0,11,0,0,128
2018-10-01 10:00:00,82,70,0,11,0,59,0,11,233
2018-10-01 11:00:00,106,118,0,0,0,11,0,35,270
2018-10-01 12:00:00,188,94,0,23,0,47,0,47,399
2018-10-01 13:00:00,295,106,0,0,0,47,0,59,507
2018-10-01 14:00:00,200,118,0,0,0,35,0,59,412
2018-10-01 15:00:00,413,82,0,11,0,47,0,70,623
2018-10-01 16:00:00,141,59,0,0,0,23,0,11,234
2018-10-01 17:00:00,129,106,0,0,0,11,0,0,246
2018-10-01 18:00:00,94,47,0,0,0,23,0,11,175
2018-10-01 19:00:00,106,11,0,0,0,35,0,47,199
2018-10-01 20:00:00,70,47,0,0,0,11,0,0,128
2018-10-01 21:00:00,23,11,0,0,0,0,0,0,34
2018-10-01 22:00:00,23,0,0,0,0,11,0,23,57
2018-10-01 23:00:00,11,0,0,0,0,0,0,0,11
2018-10-02 00:00:00,0,0,0,0,0,11,0,0,11
2018-10-02 01:00:00,0,0,0,0,0,0,0,0,0
2018-10-02 02:00:00,0,0,0,0,0,0,0,0,0
2018-10-02 03:00:00,11,0,0,0,0,0,0,0,11
2018-10-02 04:00:00,0,0,0,0,0,0,0,0,0
2018-10-02 05:00:00,11,11,0,0,0,11,0,0,33
2018-10-02 06:00:00,118,0,0,0,0,0,0,0,118
2018-10-02 07:00:00,70,0,0,0,0,0,0,0,70
2018-10-02 08:00:00,82,0,0,11,0,0,0,59,152
2018-10-02 09:00:00,118,11,0,0,0,35,0,47,211
2018-10-02 10:00:00,70,59,0,0,11,11,0,23,174
2018-10-02 11:00:00,70,35,0,0,0,0,0,47,152
2018-10-02 12:00:00,82,35,0,11,0,11,35,23,197
2018-10-02 13:00:00,94,59,11,0,0,11,188,35,398
2018-10-02 14:00:00,82,23,11,11,11,11,47,11,207
2018-10-02 15:00:00,177,35,35,0,11,0,153,11,422
2018-10-02 16:00:00,118,11,23,11,11,11,70,23,278
2018-10-02 17:00:00,118,35,11,0,0,11,11,11,197
2018-10-02 18:00:00,35,47,0,0,0,23,129,23,257
2018-10-02 19:00:00,47,23,0,0,0,11,70,11,162
2018-10-02 20:00:00,0,11,0,0,0,23,11,35,80
2018-10-02 21:00:00,23,35,0,0,11,0,47,0,116
2018-10-02 22:00:00,47,0,0,0,0,0,0,0,47
2018-10-02 23:00:00,11,0,0,0,0,0,0,0,11
2018-10-03 00:00:00,0,0,0,0,0,0,11,0,11
2018-10-03 01:00:00,0,0,0,0,0,0,23,0,23
2018-10-03 02:00:00,0,0,0,0,0,0,11,0,11
2018-10-03 03:00:00,0,0,0,0,0,0,11,0,11
2018-10-03 04:00:00,0,0,0,0,0,0,0,11,11
2018-10-03 05:00:00,23,0,0,0,0,0,11,11,45
2018-10-03 06:00:00,82,0,0,11,0,0,47,0,140
2018-10-03 07:00:00,106,11,0,0,11,0,23,23,174
2018-10-03 08:00:00,82,11,11,0,0,11,70,82,267
2018-10-03 09:00:00,106,0,35,0,11,0,59,35,246
2018-10-03 10:00:00,153,11,23,0,0,23,129,23,362
2018-10-03 11:00:00,177,118,23,11,11,70,212,23,645
2018-10-03 12:00:00,271,141,23,11,35,118,306,47,952
2018-10-03 13:00:00,283,377,70,11,59,94,259,106,1259
2018-10-03 14:00:00,259,330,35,11,23,106,424,82,1270
2018-10-03 15:00:00,165,94,11,0,23,106,212,59,670
2018-10-03 16:00:00,188,129,0,11,23,23,129,11,514
2018-10-03 17:00:00,94,94,23,118,47,35,177,0,588
2018-10-03 18:00:00,70,59,0,11,23,59,82,11,315
2018-10-03 19:00:00,70,11,0,0,23,35,23,47,209
2018-10-03 20:00:00,47,11,0,0,11,23,47,0,139
2018-10-03 21:00:00,47,11,0,0,0,23,23,11,115
2018-10-03 22:00:00,23,0,0,0,11,0,59,0,93
2018-10-03 23:00:00,35,0,0,0,0,0,11,0,46
2018-10-04 00:00:00,11,0,0,0,0,0,11,0,22
2018-10-04 01:00:00,0,0,0,0,0,0,11,0,11
2018-10-04 02:00:00,0,0,0,0,0,0,23,0,23
2018-10-04 03:00:00,11,0,0,0,0,0,11,0,22
2018-10-04 04:00:00,0,0,0,0,0,0,0,0,0
2018-10-04 05:00:00,0,0,0,0,0,0,47,0,47
2018-10-04 06:00:00,59,11,0,0,0,11,35,23,139
2018-10-04 07:00:00,82,0,0,0,0,0,70,11,163
2018-10-04 08:00:00,129,35,11,0,0,0,47,23,245
2018-10-04 09:00:00,118,23,23,0,23,47,70,0,304
2018-10-04 10:00:00,153,23,11,0,11,11,106,23,338
2018-10-04 11:00:00,70,82,0,35,23,82,153,35,480
2018-10-04 12:00:00,129,59,0,11,11,59,141,23,433
2018-10-04 13:00:00,318,82,0,23,47,70,236,47,823
2018-10-04 14:00:00,377,23,35,0,0,47,165,0,647
2018-10-04 15:00:00,165,23,59,0,0,94,153,35,529
2018-10-04 16:00:00,94,11,11,11,0,35,94,11,267
2018-10-04 17:00:00,177,0,0,0,0,35,11,23,246
2018-10-04 18:00:00,70,35,0,11,11,23,47,11,208
2018-10-04 19:00:00,59,11,0,0,0,11,35,94,210
2018-10-04 20:00:00,129,11,0,0,0,35,94,11,280
2018-10-04 21:00:00,23,11,0,0,0,11,35,0,80
2018-10-04 22:00:00,11,11,0,0,0,0,35,11,68
2018-10-04 23:00:00,11,0,0,0,0,0,35,0,46
2018-10-05 00:00:00,0,0,0,0,0,0,23,0,23
2018-10-05 01:00:00,0,0,0,0,0,0,11,0,11
2018-10-05 02:00:00,0,0,0,0,0,0,11,11,22
2018-10-05 03:00:00,11,0,0,0,0,0,11,11,33
2018-10-05 04:00:00,0,0,0,0,0,0,11,0,11
2018-10-05 05:00:00,11,0,0,0,0,0,11,23,45
2018-10-05 06:00:00,106,11,0,0,0,0,11,0,128
2018-10-05 07:00:00,70,11,0,0,0,0,35,35,151
2018-10-05 08:00:00,70,11,23,0,0,23,35,70,232
2018-10-05 09:00:00,23,35,23,0,11,35,47,0,174
2018-10-05 10:00:00,118,35,23,23,23,59,106,47,434
2018-10-05 11:00:00,212,70,82,35,23,35,177,47,681
2018-10-05 12:00:00,283,188,11,11,11,82,295,47,928
2018-10-05 13:00:00,389,118,35,23,23,35,259,35,917
2018-10-05 14:00:00,259,94,11,70,11,59,141,11,656
2018-10-05 15:00:00,236,59,23,47,23,59,106,23,576
2018-10-05 16:00:00,283,35,11,23,11,82,118,23,586
2018-10-05 17:00:00,94,70,11,11,11,59,70,23,349
2018-10-05 18:00:00,165,35,11,0,11,35,70,11,338
2018-10-05 19:00:00,82,0,0,0,23,11,23,0,139
2018-10-05 20:00:00,23,23,0,11,11,11,23,0,102
2018-10-05 21:00:00,23,11,0,0,0,0,59,11,104
2018-10-05 22:00:00,47,0,0,11,0,23,11,0,92
2018-10-05 23:00:00,59,0,0,0,11,47,11,0,128
2018-10-06 00:00:00,11,0,0,0,0,11,0,0,22
2018-10-06 01:00:00,47,23,0,11,35,11,11,0,138
2018-10-06 02:00:00,0,0,0,0,0,11,0,0,11
2018-10-06 03:00:00,11,0,0,0,0,0,0,0,11
2018-10-06 04:00:00,0,0,0,0,0,0,11,0,11
2018-10-06 05:00:00,11,0,0,0,0,0,11,0,22
2018-10-06 06:00:00,11,0,0,0,0,0,11,11,33
2018-10-06 07:00:00,35,0,0,0,0,0,23,0,58
2018-10-06 08:00:00,35,11,0,0,11,11,23,11,102
2018-10-06 09:00:00,82,47,0,70,23,35,23,0,280
2018-10-06 10:00:00,200,118,0,35,23,23,82,11,492
2018-10-06 11:00:00,271,295,11,153,35,70,283,11,1129
2018-10-06 12:00:00,354,601,23,236,11,212,554,35,2026
2018-10-06 13:00:00,448,200,11,118,23,141,767,59,1767
2018-10-06 14:00:00,306,318,11,118,23,82,684,59,1601
2018-10-06 15:00:00,259,106,23,35,23,47,542,23,1058
2018-10-06 16:00:00,236,153,35,0,0,106,354,23,907
2018-10-06 17:00:00,177,35,11,0,0,70,118,0,411
2018-10-06 18:00:00,177,0,0,11,11,11,129,0,339
2018-10-06 19:00:00,47,0,0,11,11,35,47,11,162
2018-10-06 20:00:00,23,23,0,11,0,0,35,0,92
2018-10-06 21:00:00,35,0,0,0,0,0,35,11,81
2018-10-06 22:00:00,11,0,0,11,0,0,35,0,57
2018-10-06 23:00:00,35,11,0,0,11,0,35,35,127
2018-10-07 00:00:00,11,0,0,0,0,0,0,0,11
2018-10-07 01:00:00,0,0,0,0,0,0,0,0,0
2018-10-07 02:00:00,11,11,0,0,0,0,11,35,68
2018-10-07 03:00:00,0,0,0,0,0,0,35,0,35
2018-10-07 04:00:00,0,0,0,0,0,0,11,0,11
2018-10-07 05:00:00,0,0,0,0,0,0,35,0,35
2018-10-07 06:00:00,0,0,0,0,0,0,11,0,11
2018-10-07 07:00:00,35,0,0,0,0,0,59,0,94
2018-10-07 08:00:00,11,0,0,0,11,11,35,0,68
2018-10-07 09:00:00,35,35,0,0,0,47,59,23,199
2018-10-07 10:00:00,70,35,11,0,11,11,106,23,267
2018-10-07 11:00:00,70,106,0,35,47,23,165,35,481
2018-10-07 12:00:00,271,342,23,11,141,165,483,35,1471
2018-10-07 13:00:00,448,271,59,59,141,224,1014,106,2322
2018-10-07 14:00:00,330,295,23,35,82,177,1003,106,2051
2018-10-07 15:00:00,330,177,47,47,94,177,342,106,1320
2018-10-07 16:00:00,318,118,11,11,59,118,153,47,835
2018-10-07 17:00:00,129,70,11,0,23,59,47,11,350
2018-10-07 18:00:00,236,47,0,11,0,11,23,47,375
2018-10-07 19:00:00,47,11,0,0,11,0,11,0,80
2018-10-07 20:00:00,23,11,0,0,0,11,0,0,45
2018-10-07 21:00:00,23,0,0,0,0,11,0,11,45
2018-10-07 22:00:00,35,0,0,0,0,0,11,0,46
2018-10-07 23:00:00,0,11,0,11,0,0,0,11,33
2018-10-08 00:00:00,0,0,0,0,0,0,0,0,0
2018-10-08 01:00:00,0,0,0,0,0,0,11,0,11
2018-10-08 02:00:00,11,0,0,0,0,0,11,0,22
2018-10-08 03:00:00,0,0,0,0,0,11,0,0,11
2018-10-08 04:00:00,0,0,0,0,0,0,11,0,11
2018-10-08 05:00:00,11,0,0,0,0,11,0,0,22
2018-10-08 06:00:00,11,0,0,0,0,0,23,23,57
2018-10-08 07:00:00,106,0,11,0,0,11,23,0,151
2018-10-08 08:00:00,212,11,11,0,11,11,47,59,362
2018-10-08 09:00:00,82,47,35,11,23,23,47,23,291
2018-10-08 10:00:00,59,23,0,23,11,59,70,23,268
2018-10-08 11:00:00,70,47,0,0,0,23,70,47,257
2018-10-08 12:00:00,153,35,0,0,59,23,70,11,351
2018-10-08 13:00:00,47,47,0,0,23,11,82,70,280
2018-10-08 14:00:00,283,82,0,11,0,23,82,47,528
2018-10-08 15:00:00,153,70,23,11,11,35,118,11,432
2018-10-08 16:00:00,153,129,0,0,0,11,94,23,410
2018-10-08 17:00:00,82,47,0,0,11,11,35,11,197
2018-10-08 18:00:00,106,23,0,0,23,23,47,0,222
2018-10-08 19:00:00,70,47,0,0,0,11,11,0,139
2018-10-08 20:00:00,11,11,0,0,0,0,35,0,57
2018-10-08 21:00:00,35,11,0,0,0,0,11,0,57
2018-10-08 22:00:00,23,0,0,0,0,0,0,0,23
2018-10-08 23:00:00,11,0,0,0,0,0,0,0,11
2018-10-09 00:00:00,0,0,0,0,11,11,23,11,56
2018-10-09 01:00:00,0,0,0,23,23,35,11,0,92
2018-10-09 02:00:00,0,11,0,0,23,0,11,0,45
2018-10-09 03:00:00,0,0,0,0,0,0,11,0,11
2018-10-09 04:00:00,0,0,0,0,0,0,0,0,0
2018-10-09 05:00:00,23,0,0,0,0,0,0,11,34
2018-10-09 06:00:00,59,0,0,0,0,11,0,23,93
2018-10-09 07:00:00,306,0,0,11,0,70,47,35,469
2018-10-09 08:00:00,141,11,0,0,0,23,23,106,304
2018-10-09 09:00:00,82,11,35,0,0,35,35,0,198
2018-10-09 10:00:00,129,23,23,0,0,59,70,0,304
2018-10-09 11:00:00,224,94,35,0,11,82,129,0,575
2018-10-09 12:00:00,177,23,0,0,23,59,354,59,695
2018-10-09 13:00:00,129,118,23,11,0,47,495,11,834
2018-10-09 14:00:00,306,82,11,11,11,11,177,47,656
2018-10-09 15:00:00,106,82,23,11,11,11,70,11,325
2018-10-09 16:00:00,153,82,23,11,11,35,94,23,432
2018-10-09 17:00:00,94,59,11,0,11,47,94,23,339
2018-10-09 18:00:00,153,47,0,0,0,0,82,0,282
2018-10-09 19:00:00,59,35,0,0,35,23,23,0,175
2018-10-09 20:00:00,0,35,11,0,0,0,35,0,81
2018-10-09 21:00:00,23,47,0,0,0,11,35,11,127
2018-10-09 22:00:00,23,11,11,0,0,0,47,0,92
2018-10-09 23:00:00,11,0,0,0,0,0,0,0,11
2018-10-10 00:00:00,11,0,0,0,0,0,23,0,34
2018-10-10 01:00:00,0,23,0,0,0,0,0,0,23
2018-10-10 02:00:00,0,0,0,0,0,0,11,0,11
2018-10-10 03:00:00,0,0,0,0,0,0,0,0,0
2018-10-10 04:00:00,0,0,0,0,0,0,0,0,0
2018-10-10 05:00:00,35,0,0,0,0,0,35,0,70
2018-10-10 06:00:00,47,0,0,0,11,23,11,23,115
2018-10-10 07:00:00,177,35,0,0,0,11,35,23,281
2018-10-10 08:00:00,247,11,0,0,11,11,35,106,421
2018-10-10 09:00:00,118,11,23,0,11,11,23,23,220
2018-10-10 10:00:00,82,11,0,0,11,23,70,23,220
2018-10-10 11:00:00,224,70,23,11,11,0,94,23,456
2018-10-10 12:00:00,106,59,35,11,11,59,129,23,433
2018-10-10 13:00:00,177,177,35,11,0,47,141,35,623
2018-10-10 14:00:00,460,70,23,11,11,70,271,59,975
2018-10-10 15:00:00,365,35,47,11,35,47,82,94,716
2018-10-10 16:00:00,129,47,0,0,11,35,59,59,340
2018-10-10 17:00:00,165,59,0,0,0,0,59,11,294
2018-10-10 18:00:00,94,59,11,0,0,35,70,11,280
2018-10-10 19:00:00,70,47,0,0,0,11,35,11,174
2018-10-10 20:00:00,82,11,11,11,0,23,11,0,149
2018-10-10 21:00:00,70,0,0,0,0,0,23,23,116
2018-10-10 22:00:00,35,0,0,0,0,11,23,0,69
2018-10-10 23:00:00,47,0,0,11,0,0,11,11,80
2018-10-11 00:00:00,11,0,0,0,0,0,11,0,22
2018-10-11 01:00:00,23,35,0,0,0,0,47,0,105
2018-10-11 02:00:00,23,0,0,0,0,0,11,0,34
2018-10-11 03:00:00,0,0,0,0,0,0,23,0,23
2018-10-11 04:00:00,0,11,0,0,0,0,11,0,22
2018-10-11 05:00:00,23,35,0,0,0,0,35,11,104
2018-10-11 06:00:00,118,35,0,0,0,11,35,0,199
2018-10-11 07:00:00,118,70,0,0,11,11,59,23,292
2018-10-11 08:00:00,141,47,0,0,11,47,47,106,399
2018-10-11 09:00:00,94,23,23,0,23,11,35,47,256
2018-10-11 10:00:00,129,70,11,0,11,70,59,0,350
2018-10-11 11:00:00,236,129,35,0,23,47,153,35,658
2018-10-11 12:00:00,247,247,35,0,11,59,165,23,787
2018-10-11 13:00:00,177,141,70,11,0,23,153,47,622
2018-10-11 14:00:00,318,165,23,11,11,70,106,59,763
2018-10-11 15:00:00,271,106,11,0,0,70,200,82,740
2018-10-11 16:00:00,212,70,0,0,47,47,82,59,517
2018-10-11 17:00:00,330,47,0,23,11,118,47,35,611
2018-10-11 18:00:00,212,35,0,0,11,47,94,23,422
2018-10-11 19:00:00,70,0,0,0,0,11,35,0,116
2018-10-11 20:00:00,23,23,0,0,0,11,23,23,103
2018-10-11 21:00:00,11,0,0,0,0,0,0,0,11
2018-10-11 22:00:00,0,0,0,0,0,0,23,0,23
2018-10-11 23:00:00,0,0,0,0,0,0,0,0,0
2018-10-12 00:00:00,0,0,0,0,0,0,23,0,23
2018-10-12 01:00:00,23,0,0,0,0,0,0,0,23
2018-10-12 02:00:00,11,0,0,0,0,0,11,0,22
2018-10-12 03:00:00,11,0,0,0,0,0,23,0,34
2018-10-12 04:00:00,0,0,0,0,0,0,0,0,0
2018-10-12 05:00:00,23,0,0,0,0,0,23,0,46
2018-10-12 06:00:00,129,0,0,0,0,0,23,35,187
2018-10-12 07:00:00,165,23,0,0,23,47,59,35,352
2018-10-12 08:00:00,224,35,23,0,0,23,59,118,482
2018-10-12 09:00:00,70,47,0,0,0,35,47,47,246
2018-10-12 10:00:00,94,47,11,0,23,23,59,35,292
2018-10-12 11:00:00,129,106,0,0,11,59,106,35,446
2018-10-12 12:00:00,283,35,0,0,11,35,165,47,576
2018-10-12 13:00:00,224,106,11,0,11,23,330,106,811
2018-10-12 14:00:00,401,59,0,0,23,23,177,94,777
2018-10-12 15:00:00,247,82,11,0,23,59,188,47,657
2018-10-12 16:00:00,177,47,35,35,47,59,94,35,529
2018-10-12 17:00:00,94,47,11,11,0,59,23,0,245
2018-10-12 18:00:00,129,59,0,0,47,0,59,23,317
2018-10-12 19:00:00,118,35,0,0,23,11,0,23,210
2018-10-12 20:00:00,35,35,0,11,0,23,47,11,162
2018-10-12 21:00:00,59,35,0,0,0,35,35,11,175
2018-10-12 22:00:00,59,0,0,0,11,47,23,0,140
2018-10-12 23:00:00,35,11,0,23,35,35,0,0,139
2018-10-13 00:00:00,59,0,0,0,0,11,35,0,105
2018-10-13 01:00:00,82,0,0,23,11,23,23,11,173
2018-10-13 02:00:00,47,11,0,23,0,23,0,11,115
2018-10-13 03:00:00,35,0,0,0,0,0,11,0,46
2018-10-13 04:00:00,11,0,0,0,0,0,0,0,11
2018-10-13 05:00:00,0,0,0,0,0,0,0,0,0
2018-10-13 06:00:00,11,0,0,0,0,0,11,11,33
2018-10-13 07:00:00,23,23,0,0,0,0,35,11,92
2018-10-13 08:00:00,23,0,0,0,11,35,11,0,80
2018-10-13 09:00:00,141,0,0,35,0,11,165,35,387
2018-10-13 10:00:00,224,23,0,11,0,23,129,35,445
2018-10-13 11:00:00,247,200,23,35,11,118,200,23,857
2018-10-13 12:00:00,212,247,23,82,59,94,566,23,1306
2018-10-13 13:00:00,259,354,0,106,11,141,377,11,1259
2018-10-13 14:00:00,318,177,0,59,47,224,342,59,1226
2018-10-13 15:00:00,365,153,0,59,70,82,354,47,1130
2018-10-13 16:00:00,271,94,23,0,11,47,118,0,564
2018-10-13 17:00:00,188,82,11,0,11,35,106,11,444
2018-10-13 18:00:00,94,59,0,0,11,94,23,11,292
2018-10-13 19:00:00,47,11,0,0,0,11,35,0,104
2018-10-13 20:00:00,70,0,0,0,11,0,23,0,104
2018-10-13 21:00:00,70,0,0,0,0,0,11,0,81
2018-10-13 22:00:00,23,23,0,0,0,0,47,11,104
2018-10-13 23:00:00,47,35,0,0,0,23,47,0,152
2018-10-14 00:00:00,35,0,0,0,0,0,70,0,105
2018-10-14 01:00:00,0,0,0,0,0,0,23,0,23
2018-10-14 02:00:00,11,0,0,0,0,0,0,0,11
2018-10-14 03:00:00,0,11,0,0,0,0,0,0,11
2018-10-14 04:00:00,0,0,0,0,0,0,23,0,23
2018-10-14 05:00:00,11,0,0,0,0,0,11,11,33
2018-10-14 06:00:00,0,0,0,0,0,0,11,0,11
2018-10-14 07:00:00,0,11,0,0,0,0,11,0,22
2018-10-14 08:00:00,11,0,0,0,0,0,47,0,58
2018-10-14 09:00:00,47,47,0,0,11,23,35,11,174
2018-10-14 10:00:00,59,23,11,0,0,23,70,0,186
2018-10-14 11:00:00,141,82,0,11,11,141,377,82,845
2018-10-14 12:00:00,413,802,11,11,118,236,637,47,2275
2018-10-14 13:00:00,354,342,82,106,35,365,767,47,2098
2018-10-14 14:00:00,295,271,59,35,153,224,708,153,1898
2018-10-14 15:00:00,283,224,70,0,82,165,448,35,1307
2018-10-14 16:00:00,212,82,0,11,129,141,283,23,881
2018-10-14 17:00:00,295,82,11,11,11,11,70,0,491
2018-10-14 18:00:00,82,23,0,0,11,47,118,23,304
2018-10-14 19:00:00,23,23,0,0,0,0,11,11,68
2018-10-14 20:00:00,23,23,0,0,0,11,23,35,115
2018-10-14 21:00:00,11,0,0,0,0,0,0,11,22
2018-10-14 22:00:00,0,0,11,0,0,0,11,11,33
2018-10-14 23:00:00,0,0,0,0,0,0,0,11,11
2018-10-15 00:00:00,0,0,0,0,0,0,0,0,0
2018-10-15 01:00:00,0,0,0,0,0,0,0,11,11
2018-10-15 02:00:00,0,0,0,0,0,0,0,0,0
2018-10-15 03:00:00,0,0,0,0,0,0,0,0,0
2018-10-15 04:00:00,0,0,0,0,0,0,0,0,0
2018-10-15 05:00:00,11,0,0,0,0,0,0,0,11
2018-10-15 06:00:00,82,23,11,0,0,11,0,0,127
2018-10-15 07:00:00,177,11,0,0,0,11,35,35,269
2018-10-15 08:00:00,177,23,11,0,0,0,59,70,340
2018-10-15 09:00:00,177,35,47,0,11,23,23,11,327
2018-10-15 10:00:00,59,11,59,0,0,11,70,11,221
2018-10-15 11:00:00,118,47,0,0,11,35,94,23,328
2018-10-15 12:00:00,153,106,11,0,23,47,106,47,493
2018-10-15 13:00:00,35,47,0,0,35,23,141,35,316
2018-10-15 14:00:00,283,59,23,0,23,59,165,106,718
2018-10-15 15:00:00,236,82,23,11,59,47,106,11,575
2018-10-15 16:00:00,141,47,0,0,11,11,35,23,268
2018-10-15 17:00:00,82,47,0,0,0,11,47,0,187
2018-10-15 18:00:00,141,11,0,0,0,0,59,11,222
2018-10-15 19:00:00,236,0,0,0,11,11,70,0,328
2018-10-15 20:00:00,23,0,0,0,11,0,11,59,104
2018-10-15 21:00:00,35,0,0,0,0,0,11,0,46
2018-10-15 22:00:00,23,0,0,0,0,0,11,0,34
2018-10-15 23:00:00,0,0,0,0,0,0,0,11,11
2018-10-16 00:00:00,0,0,0,0,0,0,0,0,0
2018-10-16 01:00:00,0,0,0,0,0,0,0,0,0
2018-10-16 02:00:00,0,0,0,0,0,0,0,0,0
2018-10-16 03:00:00,0,0,0,0,0,0,0,0,0
2018-10-16 04:00:00,0,0,0,0,0,0,11,0,11
2018-10-16 05:00:00,11,0,0,0,0,0,0,11,22
2018-10-16 06:00:00,59,23,0,0,0,11,0,11,104
2018-10-16 07:00:00,165,23,0,11,0,23,11,35,268
2018-10-16 08:00:00,212,47,23,0,0,35,70,106,493
2018-10-16 09:00:00,82,23,11,0,11,35,47,23,232
2018-10-16 10:00:00,47,35,47,11,11,23,70,11,255
2018-10-16 11:00:00,70,47,11,0,11,59,35,47,280
2018-10-16 12:00:00,188,94,23,11,495,59,177,11,1058
2018-10-16 13:00:00,153,59,11,11,436,106,106,11,893
2018-10-16 14:00:00,236,94,11,11,11,0,236,59,658
2018-10-16 15:00:00,389,94,11,0,0,0,129,23,646
2018-10-16 16:00:00,212,59,23,0,35,11,106,47,493
2018-10-16 17:00:00,47,94,11,11,0,47,47,0,257
2018-10-16 18:00:00,94,47,11,0,11,35,70,0,268
2018-10-16 19:00:00,35,0,23,0,23,70,11,0,162
2018-10-16 20:00:00,23,35,23,0,11,23,106,11,232
2018-10-16 21:00:00,59,35,0,0,0,23,47,0,164
2018-10-16 22:00:00,59,0,0,0,0,0,35,0,94
2018-10-16 23:00:00,23,0,0,0,0,0,47,0,70
2018-10-17 00:00:00,11,0,0,0,0,0,23,0,34
2018-10-17 01:00:00,0,0,0,0,0,0,11,11,22
2018-10-17 02:00:00,0,0,0,0,0,0,11,0,11
2018-10-17 03:00:00,0,0,0,0,0,0,0,0,0
2018-10-17 04:00:00,0,0,0,0,0,0,0,0,0
2018-10-17 05:00:00,11,0,0,0,0,0,0,0,11
2018-10-17 06:00:00,82,11,0,0,0,0,23,0,116
2018-10-17 07:00:00,118,23,0,0,0,11,70,47,269
2018-10-17 08:00:00,200,11,23,0,11,0,23,141,409
2018-10-17 09:00:00,70,11,11,0,23,35,11,0,161
2018-10-17 10:00:00,82,70,11,0,11,11,35,35,255
2018-10-17 11:00:00,118,47,94,0,0,11,47,23,340
2018-10-17 12:00:00,129,47,35,11,11,35,82,23,373
2018-10-17 13:00:00,82,23,47,0,11,23,23,23,232
2018-10-17 14:00:00,224,82,82,0,23,47,94,70,622
2018-10-17 15:00:00,247,59,11,0,23,47,59,35,481
2018-10-17 16:00:00,200,47,0,0,11,0,23,23,304
2018-10-17 17:00:00,94,47,0,23,0,23,23,35,245
2018-10-17 18:00:00,106,23,0,11,0,23,59,0,222
2018-10-17 19:00:00,82,23,11,11,23,23,23,47,243
2018-10-17 20:00:00,23,11,11,0,0,11,59,0,115
2018-10-17 21:00:00,35,0,0,0,0,11,11,11,68
2018-10-17 22:00:00,94,23,0,0,0,0,0,11,128
2018-10-17 23:00:00,23,0,0,0,0,11,47,0,81
2018-10-18 00:00:00,0,0,0,0,0,11,11,0,22
2018-10-18 01:00:00,0,0,0,0,0,0,0,11,11
2018-10-18 02:00:00,11,0,0,0,0,0,0,0,11
2018-10-18 03:00:00,11,0,0,0,0,0,11,0,22
2018-10-18 04:00:00,0,0,0,0,0,0,0,0,0
2018-10-18 05:00:00,35,0,0,0,0,0,11,0,46
2018-10-18 06:00:00,59,11,0,0,0,0,0,11,81
2018-10-18 07:00:00,224,23,0,11,0,0,47,35,340
2018-10-18 08:00:00,165,47,11,0,0,0,23,82,328
2018-10-18 09:00:00,129,0,0,0,11,23,11,35,209
2018-10-18 10:00:00,153,70,11,0,11,11,0,23,279
2018-10-18 11:00:00,259,94,23,35,0,59,0,11,481
2018-10-18 12:00:00,318,141,35,11,23,59,0,70,657
2018-10-18 13:00:00,365,47,59,11,59,118,0,94,753
2018-10-18 14:00:00,401,129,11,11,11,70,0,82,715
2018-10-18 15:00:00,330,129,23,11,23,129,0,35,680
2018-10-18 16:00:00,141,23,11,11,23,11,0,35,255
2018-10-18 17:00:00,177,165,11,0,0,23,0,23,399
2018-10-18 18:00:00,389,106,23,0,11,47,0,47,623
2018-10-18 19:00:00,82,35,0,0,11,23,0,23,174
2018-10-18 20:00:00,94,11,0,0,11,23,0,23,162
2018-10-18 21:00:00,35,0,0,0,0,0,0,11,46
2018-10-18 22:00:00,47,0,0,0,0,0,0,0,47
2018-10-18 23:00:00,0,11,0,0,0,0,0,0,11
2018-10-19 00:00:00,11,23,0,0,0,0,0,0,34
2018-10-19 01:00:00,0,0,0,0,0,0,0,0,0
2018-10-19 02:00:00,11,0,0,0,0,0,11,0,22
2018-10-19 03:00:00,0,0,0,0,0,0,0,0,0
2018-10-19 04:00:00,0,0,0,0,0,0,11,0,11
2018-10-19 05:00:00,11,11,0,0,0,0,0,0,22
2018-10-19 06:00:00,23,23,0,0,0,11,35,0,92
2018-10-19 07:00:00,212,0,0,11,11,35,35,23,327
2018-10-19 08:00:00,200,11,0,11,0,35,59,153,469
2018-10-19 09:00:00,94,23,23,23,0,11,59,0,233
2018-10-19 10:00:00,259,0,11,0,23,23,82,11,409
2018-10-19 11:00:00,177,47,0,0,23,82,153,47,529
2018-10-19 12:00:00,271,35,0,0,0,23,70,59,458
2018-10-19 13:00:00,389,82,11,0,11,59,200,70,822
2018-10-19 14:00:00,460,82,0,0,11,11,236,82,882
2018-10-19 15:00:00,259,94,11,0,23,47,224,0,658
2018-10-19 16:00:00,106,35,0,0,11,11,35,11,209
2018-10-19 17:00:00,59,0,0,11,11,11,35,0,127
2018-10-19 18:00:00,59,23,0,0,0,0,59,0,141
2018-10-19 19:00:00,35,0,0,0,0,0,35,0,70
2018-10-19 20:00:00,11,0,0,0,0,0,23,0,34
2018-10-19 21:00:00,11,0,0,0,11,0,11,0,33
2018-10-19 22:00:00,0,0,0,0,0,0,23,0,23
2018-10-19 23:00:00,0,0,0,0,0,0,11,0,11
2018-10-20 00:00:00,47,0,0,0,0,11,35,23,116
2018-10-20 01:00:00,11,11,0,0,0,0,11,0,33
2018-10-20 02:00:00,0,0,0,0,0,0,23,23,46
2018-10-20 03:00:00,0,0,0,0,0,0,0,0,0
2018-10-20 04:00:00,0,0,0,0,0,0,11,11,22
2018-10-20 05:00:00,0,0,0,0,0,0,11,0,11
2018-10-20 06:00:00,0,0,0,0,0,0,11,0,11
2018-10-20 07:00:00,23,0,0,0,0,0,23,0,46
2018-10-20 08:00:00,82,11,11,11,0,11,59,0,185
2018-10-20 09:00:00,82,0,0,35,0,11,47,0,175
2018-10-20 10:00:00,129,23,0,47,0,35,118,11,363
2018-10-20 11:00:00,153,141,0,118,23,35,212,35,717
2018-10-20 12:00:00,306,708,23,200,35,153,908,23,2356
2018-10-20 13:00:00,306,424,47,247,23,200,1309,35,2591
2018-10-20 14:00:00,389,259,0,106,35,106,672,82,1649
2018-10-20 15:00:00,354,70,11,70,47,106,318,59,1035
2018-10-20 16:00:00,200,82,0,23,23,70,177,23,598
2018-10-20 17:00:00,118,23,0,0,11,11,94,11,268
2018-10-20 18:00:00,70,35,0,0,0,0,82,0,187
2018-10-20 19:00:00,0,11,0,0,0,0,23,0,34
2018-10-20 20:00:00,0,0,0,0,0,0,35,0,35
2018-10-20 21:00:00,11,0,0,0,0,0,35,0,46
2018-10-20 22:00:00,0,0,0,0,0,0,23,0,23
2018-10-20 23:00:00,0,0,0,0,0,0,35,0,35
2018-10-21 00:00:00,23,0,0,0,0,11,47,11,92
2018-10-21 01:00:00,23,0,11,0,0,0,0,0,34
2018-10-21 02:00:00,35,0,0,0,0,0,47,11,93
2018-10-21 03:00:00,11,0,0,0,0,0,23,11,45
2018-10-21 04:00:00,11,0,0,0,0,0,0,0,11
2018-10-21 05:00:00,0,0,0,0,0,11,11,0,22
2018-10-21 06:00:00,23,0,0,0,0,0,11,0,34
2018-10-21 07:00:00,0,0,0,0,0,0,11,0,11
2018-10-21 08:00:00,11,0,0,0,0,0,11,0,22
2018-10-21 09:00:00,0,11,11,0,0,11,70,0,103
2018-10-21 10:00:00,35,59,0,0,0,11,35,11,151
2018-10-21 11:00:00,70,106,0,11,23,118,59,23,410
2018-10-21 12:00:00,212,106,23,11,23,82,259,82,798
2018-10-21 13:00:00,224,200,23,35,59,165,401,11,1118
2018-10-21 14:00:00,330,283,35,11,94,70,495,59,1377
2018-10-21 15:00:00,188,212,11,23,11,47,200,23,715
2018-10-21 16:00:00,118,59,23,0,23,11,59,35,328
2018-10-21 17:00:00,11,11,11,11,0,11,35,11,101
2018-10-21 18:00:00,0,11,0,0,0,0,35,11,57
2018-10-21 19:00:00,11,11,0,0,0,0,23,11,56
2018-10-21 20:00:00,11,0,0,0,0,23,11,0,45
2018-10-21 21:00:00,0,11,0,0,11,23,0,0,45
2018-10-21 22:00:00,0,0,0,0,0,0,23,0,23
2018-10-21 23:00:00,0,0,0,0,0,0,11,0,11
2018-10-22 00:00:00,11,0,0,0,0,0,35,0,46
2018-10-22 01:00:00,0,0,0,0,0,0,47,11,58
2018-10-22 02:00:00,0,0,0,0,0,0,11,0,11
2018-10-22 03:00:00,0,0,0,0,0,0,23,11,34
2018-10-22 04:00:00,0,0,0,0,0,0,11,0,11
2018-10-22 05:00:00,11,0,0,0,0,0,23,0,34
2018-10-22 06:00:00,129,0,0,0,0,0,23,11,163
2018-10-22 07:00:00,165,0,0,0,11,11,35,35,257
2018-10-22 08:00:00,129,35,23,0,0,23,35,47,292
2018-10-22 09:00:00,23,23,47,11,0,23,59,47,233
2018-10-22 10:00:00,35,35,11,11,11,70,94,35,302
2018-10-22 11:00:00,129,70,0,0,0,11,118,23,351
2018-10-22 12:00:00,153,59,23,0,11,35,94,70,445
2018-10-22 13:00:00,70,47,11,11,11,23,94,11,278
2018-10-22 14:00:00,165,23,11,0,0,11,11,70,291
2018-10-22 15:00:00,70,23,47,0,0,59,23,35,257
2018-10-22 16:00:00,153,23,11,0,0,35,23,0,245
2018-10-22 17:00:00,23,47,0,0,0,23,35,0,128
2018-10-22 18:00:00,23,23,0,0,0,0,11,0,57
2018-10-22 19:00:00,11,23,0,11,0,11,0,0,56
2018-10-22 20:00:00,11,35,11,0,0,0,11,0,68
2018-10-22 21:00:00,11,0,0,0,0,0,0,0,11
2018-10-22 22:00:00,0,0,0,0,0,0,0,0,0
2018-10-22 23:00:00,0,0,0,0,0,11,0,0,11
2018-10-23 00:00:00,0,0,0,0,0,0,0,0,0
2018-10-23 01:00:00,0,0,0,0,0,11,0,0,11
2018-10-23 02:00:00,0,0,0,0,0,0,11,0,11
2018-10-23 03:00:00,0,0,0,0,0,11,11,0,22
2018-10-23 04:00:00,0,0,0,0,0,0,11,0,11
2018-10-23 05:00:00,11,0,0,0,0,0,11,0,22
2018-10-23 06:00:00,47,0,0,0,11,11,47,11,127
2018-10-23 07:00:00,141,47,0,0,11,35,129,23,386
2018-10-23 08:00:00,165,35,0,0,11,35,23,70,339
2018-10-23 09:00:00,82,11,23,0,11,0,23,11,161
2018-10-23 10:00:00,82,23,35,0,11,11,118,23,303
2018-10-23 11:00:00,247,70,0,0,0,0,153,35,505
2018-10-23 12:00:00,342,70,106,0,0,35,236,47,836
2018-10-23 13:00:00,177,70,23,11,23,23,271,35,633
2018-10-23 14:00:00,377,59,35,11,47,47,318,70,964
2018-10-23 15:00:00,247,35,70,11,47,59,118,35,622
2018-10-23 16:00:00,188,59,0,23,0,11,82,23,386
2018-10-23 17:00:00,165,70,11,0,0,70,23,11,350
2018-10-23 18:00:00,460,0,23,0,35,70,141,11,740
2018-10-23 19:00:00,94,47,23,11,23,23,94,23,338
2018-10-23 20:00:00,82,23,11,0,11,23,0,23,173
2018-10-23 21:00:00,35,11,11,0,11,0,59,0,127
2018-10-23 22:00:00,23,11,11,0,0,11,35,0,91
2018-10-23 23:00:00,0,11,0,0,0,0,47,0,58
2018-10-24 00:00:00,0,0,0,0,0,0,35,0,35
2018-10-24 01:00:00,0,0,0,0,0,0,0,0,0
2018-10-24 02:00:00,0,0,0,0,0,0,0,0,0
2018-10-24 03:00:00,11,0,0,0,0,0,11,0,22
2018-10-24 04:00:00,11,0,0,0,0,0,0,0,11
2018-10-24 05:00:00,23,0,0,0,0,0,11,11,45
2018-10-24 06:00:00,94,11,0,0,0,0,23,11,139
2018-10-24 07:00:00,236,23,23,11,23,0,82,11,409
2018-10-24 08:00:00,141,47,70,11,23,11,59,82,444
2018-10-24 09:00:00,118,47,11,11,0,11,82,23,303
2018-10-24 10:00:00,129,118,35,0,11,47,118,0,458
2018-10-24 11:00:00,141,70,23,11,0,106,82,23,456
2018-10-24 12:00:00,188,70,0,0,47,47,188,23,563
2018-10-24 13:00:00,224,129,59,0,11,35,177,35,670
2018-10-24 14:00:00,271,23,0,23,0,70,141,94,622
2018-10-24 15:00:00,177,23,11,11,35,59,82,59,457
2018-10-24 16:00:00,35,70,0,0,11,11,59,23,209
2018-10-24 17:00:00,118,23,11,0,0,11,47,0,210
2018-10-24 18:00:00,106,70,0,0,0,11,188,11,386
2018-10-24 19:00:00,82,35,0,0,11,0,47,23,198
2018-10-24 20:00:00,70,47,0,0,0,0,23,0,140
2018-10-24 21:00:00,165,23,11,0,35,59,59,0,352
2018-10-24 22:00:00,82,0,0,0,0,23,35,11,151
2018-10-24 23:00:00,11,0,0,0,0,0,59,0,70
2018-10-25 00:00:00,11,0,0,0,0,0,11,0,22
2018-10-25 01:00:00,0,0,0,0,0,11,23,0,34
2018-10-25 02:00:00,0,0,0,0,0,0,23,0,23
2018-10-25 03:00:00,0,0,0,0,0,0,11,0,11
2018-10-25 04:00:00,11,0,0,0,0,0,11,0,22
2018-10-25 05:00:00,23,0,0,0,0,0,23,0,46
2018-10-25 06:00:00,59,11,0,0,0,0,35,0,105
2018-10-25 07:00:00,129,47,0,0,0,0,59,11,246
2018-10-25 08:00:00,259,35,23,0,0,0,94,94,505
2018-10-25 09:00:00,106,0,35,0,0,35,59,11,246
2018-10-25 10:00:00,129,94,35,0,11,59,118,23,469
2018-10-25 11:00:00,129,106,11,11,11,47,153,23,491
2018-10-25 12:00:00,224,129,23,0,0,47,236,35,694
2018-10-25 13:00:00,531,106,11,23,23,70,165,23,952
2018-10-25 14:00:00,354,70,11,0,47,35,177,59,753
2018-10-25 15:00:00,153,94,23,0,0,11,106,11,398
2018-10-25 16:00:00,318,23,11,0,23,11,106,23,515
2018-10-25 17:00:00,106,47,0,0,0,23,82,11,269
2018-10-25 18:00:00,212,0,0,11,0,35,59,0,317
2018-10-25 19:00:00,354,11,0,11,11,11,35,0,433
2018-10-25 20:00:00,47,0,0,0,0,11,70,11,139
2018-10-25 21:00:00,0,23,0,11,0,11,70,11,126
2018-10-25 22:00:00,0,0,0,0,0,0,35,0,35
2018-10-25 23:00:00,0,0,0,0,0,0,35,11,46
2018-10-26 00:00:00,0,11,0,0,0,0,35,0,46
2018-10-26 01:00:00,11,0,0,0,0,0,11,0,22
2018-10-26 02:00:00,0,0,0,0,0,0,0,0,0
2018-10-26 03:00:00,0,0,0,0,0,0,0,0,0
2018-10-26 04:00:00,0,0,0,0,0,0,0,0,0
2018-10-26 05:00:00,23,0,0,0,0,0,23,0,46
2018-10-26 06:00:00,23,11,0,0,0,0,47,0,81
2018-10-26 07:00:00,177,0,0,0,0,11,59,23,270
2018-10-26 08:00:00,106,11,23,0,0,0,35,35,210
2018-10-26 09:00:00,59,35,0,11,0,23,35,0,163
2018-10-26 10:00:00,94,0,59,11,0,11,94,0,269
2018-10-26 11:00:00,129,82,23,11,11,35,247,47,585
2018-10-26 12:00:00,200,23,11,0,11,35,129,11,420
2018-10-26 13:00:00,153,59,11,0,35,70,236,23,587
2018-10-26 14:00:00,472,11,23,11,0,35,94,70,716
2018-10-26 15:00:00,200,59,0,0,11,23,141,23,457
2018-10-26 16:00:00,141,35,0,11,0,0,82,0,269
2018-10-26 17:00:00,82,59,11,35,0,23,129,0,339
2018-10-26 18:00:00,94,23,59,0,0,59,82,0,317
2018-10-26 19:00:00,35,35,0,0,11,11,82,0,174
2018-10-26 20:00:00,23,11,0,0,11,23,35,11,114
2018-10-26 21:00:00,82,23,0,0,0,11,82,0,198
2018-10-26 22:00:00,141,0,11,0,0,70,59,0,281
2018-10-26 23:00:00,165,11,0,11,0,59,35,0,281
2018-10-27 00:00:00,23,0,0,0,0,11,0,11,45
2018-10-27 01:00:00,35,0,0,0,0,11,11,0,57
2018-10-27 02:00:00,11,0,0,0,0,0,23,23,57
2018-10-27 03:00:00,11,0,0,0,11,11,11,0,44
2018-10-27 04:00:00,0,11,0,0,0,0,11,0,22
2018-10-27 05:00:00,11,0,11,0,0,0,23,0,45
2018-10-27 06:00:00,0,0,0,0,0,11,0,0,11
2018-10-27 07:00:00,23,0,0,0,0,0,0,0,23
2018-10-27 08:00:00,47,0,0,0,0,0,35,23,105
2018-10-27 09:00:00,35,47,0,35,0,23,23,0,163
2018-10-27 10:00:00,23,129,11,35,23,23,106,0,350
2018-10-27 11:00:00,271,118,35,35,0,118,365,11,953
2018-10-27 12:00:00,472,271,35,94,0,82,483,0,1437
2018-10-27 13:00:00,212,177,11,47,82,82,979,0,1590
2018-10-27 14:00:00,495,236,11,70,70,70,483,0,1435
2018-10-27 15:00:00,212,177,11,11,47,106,424,23,1011
2018-10-27 16:00:00,94,165,0,0,0,35,271,35,600
2018-10-27 17:00:00,165,23,0,11,11,35,70,35,350
2018-10-27 18:00:00,70,47,11,0,11,94,59,0,292
2018-10-27 19:00:00,82,23,0,11,0,23,23,0,162
2018-10-27 20:00:00,59,11,0,11,11,11,35,0,138
2018-10-27 21:00:00,59,0,0,0,0,0,35,0,94
2018-10-27 22:00:00,35,11,0,0,0,0,11,0,57
2018-10-27 23:00:00,23,0,0,0,11,11,23,0,68
2018-10-28 00:00:00,35,0,0,0,11,0,23,0,69
2018-10-28 01:00:00,59,0,11,0,11,0,0,0,81
2018-10-28 02:00:00,11,11,0,0,0,23,11,11,67
2018-10-28 03:00:00,0,0,0,0,0,0,0,0,0
2018-10-28 04:00:00,0,0,0,0,0,0,0,0,0
2018-10-28 05:00:00,0,0,0,0,0,0,0,0,0
2018-10-28 06:00:00,0,0,0,0,0,0,11,0,11
2018-10-28 07:00:00,23,0,11,0,11,0,35,0,80
2018-10-28 08:00:00,0,11,11,0,0,11,35,0,68
2018-10-28 09:00:00,23,23,11,0,0,23,47,0,127
2018-10-28 10:00:00,47,82,11,0,11,35,118,35,339
2018-10-28 11:00:00,141,236,47,35,47,94,188,23,811
2018-10-28 12:00:00,236,224,0,82,47,200,696,11,1496
2018-10-28 13:00:00,247,212,23,0,70,118,767,82,1519
2018-10-28 14:00:00,200,165,59,0,47,200,531,35,1237
2018-10-28 15:00:00,283,129,47,35,47,94,259,47,941
2018-10-28 16:00:00,177,94,0,23,11,35,188,0,528
2018-10-28 17:00:00,35,11,11,0,0,23,47,0,127
2018-10-28 18:00:00,0,0,0,0,0,23,0,0,23
2018-10-28 19:00:00,59,11,11,0,11,0,23,0,115
2018-10-28 20:00:00,0,11,0,0,0,23,23,11,68
2018-10-28 21:00:00,23,23,0,0,0,0,0,0,46
2018-10-28 22:00:00,0,23,0,0,11,0,11,11,56
2018-10-28 23:00:00,11,0,0,0,0,0,11,0,22
2018-10-29 00:00:00,0,0,11,0,0,0,11,0,22
2018-10-29 01:00:00,0,0,0,0,0,11,0,0,11
2018-10-29 02:00:00,0,0,11,0,0,0,11,0,22
2018-10-29 03:00:00,0,0,0,0,0,0,0,0,0
2018-10-29 04:00:00,11,0,0,0,0,0,0,0,11
2018-10-29 05:00:00,11,0,11,0,0,0,0,11,33
2018-10-29 06:00:00,70,0,23,0,11,11,11,11,137
2018-10-29 07:00:00,224,35,35,0,0,23,0,35,352
2018-10-29 08:00:00,47,0,35,0,0,23,47,141,293
2018-10-29 09:00:00,47,47,35,0,11,11,23,23,197
2018-10-29 10:00:00,70,23,35,0,0,0,47,11,186
2018-10-29 11:00:00,82,23,23,11,0,11,106,0,256
2018-10-29 12:00:00,153,23,11,11,23,11,106,59,397
2018-10-29 13:00:00,165,35,35,0,35,35,94,47,446
2018-10-29 14:00:00,295,47,11,0,11,0,70,70,504
2018-10-29 15:00:00,318,23,47,0,59,0,82,59,588
2018-10-29 16:00:00,94,23,0,0,11,0,106,11,245
2018-10-29 17:00:00,106,11,0,11,23,11,94,23,279
2018-10-29 18:00:00,70,11,0,0,0,0,94,0,175
2018-10-29 19:00:00,70,0,0,0,0,0,47,0,117
2018-10-29 20:00:00,94,0,0,0,11,0,59,0,164
2018-10-29 21:00:00,59,0,0,0,11,0,94,0,164
2018-10-29 22:00:00,47,0,0,0,0,0,82,0,129
2018-10-29 23:00:00,11,0,0,0,0,0,0,0,11
2018-10-30 00:00:00,35,0,0,47,0,0,0,0,82
2018-10-30 01:00:00,0,0,0,23,0,0,0,11,34
2018-10-30 02:00:00,0,0,0,11,0,0,11,0,22
2018-10-30 03:00:00,23,0,0,11,0,0,0,11,45
2018-10-30 04:00:00,11,0,0,23,0,0,23,0,57
2018-10-30 05:00:00,11,0,0,0,0,0,11,0,22
2018-10-30 06:00:00,106,0,0,11,0,0,59,0,176
2018-10-30 07:00:00,188,23,0,23,0,11,47,11,303
2018-10-30 08:00:00,82,47,11,11,11,0,82,59,303
2018-10-30 09:00:00,82,11,0,23,11,0,59,23,209
2018-10-30 10:00:00,82,35,11,23,11,11,129,0,302
2018-10-30 11:00:00,129,47,11,0,0,23,177,0,387
2018-10-30 12:00:00,106,106,11,0,11,11,153,11,409
2018-10-30 13:00:00,70,70,23,0,0,0,141,35,339
2018-10-30 14:00:00,141,23,11,0,11,11,129,47,373
2018-10-30 15:00:00,141,70,11,11,11,11,47,11,313
2018-10-30 16:00:00,94,0,0,0,11,23,118,11,257
2018-10-30 17:00:00,70,11,23,11,23,0,118,0,256
2018-10-30 18:00:00,188,47,23,23,35,0,141,0,457
2018-10-30 19:00:00,70,23,11,0,47,70,82,0,303
2018-10-30 20:00:00,35,11,23,0,0,23,59,0,151
2018-10-30 21:00:00,118,11,0,0,0,11,94,11,245
2018-10-30 22:00:00,70,0,0,0,0,0,47,0,117
2018-10-30 23:00:00,47,0,0,0,0,0,59,0,106
2018-10-31 00:00:00,11,11,0,0,0,0,11,11,44
2018-10-31 01:00:00,0,0,0,0,0,0,11,0,11
2018-10-31 02:00:00,11,0,0,0,0,0,0,0,11
2018-10-31 03:00:00,0,0,0,0,0,0,11,0,11
2018-10-31 04:00:00,23,0,0,0,0,0,0,0,23
2018-10-31 05:00:00,11,11,0,0,0,0,0,0,22
2018-10-31 06:00:00,70,0,0,0,0,0,0,23,93
2018-10-31 07:00:00,177,11,11,0,0,11,11,47,268
2018-10-31 08:00:00,94,23,70,0,0,11,11,70,279
2018-10-31 09:00:00,94,35,11,11,11,23,70,11,266
2018-10-31 10:00:00,153,82,23,0,0,59,59,11,387
2018-10-31 11:00:00,118,129,0,35,23,23,59,0,387
2018-10-31 12:00:00,70,106,0,11,23,0,224,11,445
2018-10-31 13:00:00,0,59,0,11,35,11,94,59,269
2018-10-31 14:00:00,0,23,35,0,0,23,70,82,233
2018-10-31 15:00:00,0,59,23,11,23,11,129,70,326
2018-10-31 16:00:00,0,47,11,0,0,11,70,47,186
2018-10-31 17:00:00,0,23,35,0,11,11,47,11,138
2018-10-31 18:00:00,0,23,0,0,11,11,94,0,139
2018-10-31 19:00:00,0,59,0,0,11,0,35,23,128
2018-10-31 20:00:00,0,35,0,0,11,11,11,23,91
2018-10-31 21:00:00,0,0,0,0,0,23,11,0,34
2018-10-31 22:00:00,0,11,35,0,23,23,35,0,127
2018-10-31 23:00:00,0,0,11,0,0,23,23,23,80
2018-11-01 00:00:00,23,0,0,0,0,11,23,0,57
2018-11-01 01:00:00,11,0,0,0,0,0,0,0,11
2018-11-01 02:00:00,23,0,0,0,0,0,23,0,46
2018-11-01 03:00:00,11,0,0,0,0,0,23,0,34
2018-11-01 04:00:00,59,0,0,0,0,0,23,11,93
2018-11-01 05:00:00,11,0,0,0,0,0,35,11,57
2018-11-01 06:00:00,118,0,0,0,0,0,47,0,165
2018-11-01 07:00:00,118,0,0,0,0,0,70,59,247
2018-11-01 08:00:00,106,0,0,0,11,11,47,47,222
2018-11-01 09:00:00,106,0,23,0,35,70,94,35,363
2018-11-01 10:00:00,94,47,35,0,23,11,106,0,316
2018-11-01 11:00:00,153,94,0,0,47,59,188,11,552
2018-11-01 12:00:00,295,82,11,23,47,35,188,59,740
2018-11-01 13:00:00,224,94,23,11,11,165,188,11,727
2018-11-01 14:00:00,330,59,11,0,23,82,141,70,716
2018-11-01 15:00:00,306,82,23,0,35,23,177,35,681
2018-11-01 16:00:00,212,59,59,11,23,35,153,59,611
2018-11-01 17:00:00,200,35,0,11,11,70,82,23,432
2018-11-01 18:00:00,47,0,0,0,11,23,23,0,104
2018-11-01 19:00:00,0,0,0,0,11,11,11,11,44
2018-11-01 20:00:00,11,11,11,0,0,0,11,0,44
2018-11-01 21:00:00,47,0,0,0,0,0,11,0,58
2018-11-01 22:00:00,11,0,0,0,0,11,0,0,22
2018-11-01 23:00:00,0,0,0,0,0,0,0,0,0
2018-11-02 00:00:00,0,0,0,0,0,0,11,0,11
2018-11-02 01:00:00,11,0,0,0,0,0,11,0,22
2018-11-02 02:00:00,0,0,0,0,0,0,11,0,11
2018-11-02 03:00:00,0,0,0,0,0,0,11,0,11
2018-11-02 04:00:00,11,0,0,0,0,0,11,0,22
2018-11-02 05:00:00,23,0,0,0,0,0,0,0,23
2018-11-02 06:00:00,70,11,0,0,0,11,23,23,138
2018-11-02 07:00:00,200,23,0,0,0,11,35,35,304
2018-11-02 08:00:00,94,23,70,0,11,11,70,70,349
2018-11-02 09:00:00,47,23,11,0,0,23,47,23,174
2018-11-02 10:00:00,82,11,11,0,11,0,59,11,185
2018-11-02 11:00:00,82,23,0,0,0,23,165,23,316
2018-11-02 12:00:00,177,11,0,0,0,0,129,23,340
2018-11-02 13:00:00,129,23,47,35,0,35,106,11,386
2018-11-02 14:00:00,224,59,23,11,0,23,141,47,528
2018-11-02 15:00:00,118,35,0,0,11,23,129,11,327
2018-11-02 16:00:00,129,11,0,0,0,11,153,47,351
2018-11-02 17:00:00,35,35,0,11,0,0,94,23,198
2018-11-02 18:00:00,70,35,0,82,0,11,35,23,256
2018-11-02 19:00:00,35,47,0,118,11,0,70,0,281
2018-11-02 20:00:00,70,11,11,0,0,23,11,11,137
2018-11-02 21:00:00,35,0,0,23,0,0,59,0,117
2018-11-02 22:00:00,35,11,0,23,0,35,35,0,139
2018-11-02 23:00:00,70,11,0,0,0,23,23,11,138
2018-11-03 00:00:00,0,23,0,0,11,11,47,0,92
2018-11-03 01:00:00,0,11,0,0,0,11,0,0,22
2018-11-03 02:00:00,0,0,0,0,0,0,0,0,0
2018-11-03 03:00:00,0,0,0,0,0,0,0,0,0
2018-11-03 04:00:00,0,0,0,0,0,0,11,0,11
2018-11-03 05:00:00,11,0,0,0,0,0,11,0,22
2018-11-03 06:00:00,0,0,0,0,0,0,11,11,22
2018-11-03 07:00:00,23,11,0,0,0,0,0,0,34
2018-11-03 08:00:00,47,11,11,0,0,0,35,0,104
2018-11-03 09:00:00,47,0,0,11,0,11,11,0,80
2018-11-03 10:00:00,0,23,23,70,11,0,165,0,292
2018-11-03 11:00:00,0,106,0,106,11,129,224,118,694
2018-11-03 12:00:00,0,283,35,236,47,153,637,47,1438
2018-11-03 13:00:00,259,318,23,106,106,153,601,11,1577
2018-11-03 14:00:00,531,247,0,129,23,129,460,23,1542
2018-11-03 15:00:00,177,141,0,59,11,47,295,23,753
2018-11-03 16:00:00,236,47,0,47,35,47,354,11,777
2018-11-03 17:00:00,200,47,23,11,23,47,153,23,527
2018-11-03 18:00:00,70,11,0,35,11,35,35,23,220
2018-11-03 19:00:00,70,11,0,35,23,35,82,11,267
2018-11-03 20:00:00,129,35,0,35,0,11,35,23,268
2018-11-03 21:00:00,23,0,0,23,0,0,11,11,68
2018-11-03 22:00:00,35,35,0,11,11,11,23,0,126
2018-11-03 23:00:00,11,11,0,11,0,0,23,23,79
2018-11-04 00:00:00,35,11,0,0,0,11,23,11,91
2018-11-04 01:00:00,23,0,0,0,0,0,0,11,34
2018-11-04 02:00:00,35,11,0,0,0,0,11,0,57
2018-11-04 03:00:00,11,0,0,0,0,0,23,0,34
2018-11-04 04:00:00,0,0,0,0,0,11,0,0,11
2018-11-04 05:00:00,0,0,0,0,0,0,0,0,0
2018-11-04 06:00:00,0,0,0,0,0,0,0,0,0
2018-11-04 07:00:00,11,0,0,0,0,0,23,11,45
2018-11-04 08:00:00,0,0,0,0,0,0,0,0,0
2018-11-04 09:00:00,11,35,35,0,0,0,11,0,92
2018-11-04 10:00:00,82,82,0,0,0,23,47,11,245
2018-11-04 11:00:00,129,165,0,0,11,11,141,11,468
2018-11-04 12:00:00,153,271,35,23,47,129,377,35,1070
2018-11-04 13:00:00,188,200,35,23,82,141,483,0,1152
2018-11-04 14:00:00,200,129,11,23,94,177,483,35,1152
2018-11-04 15:00:00,247,94,35,11,0,106,448,47,988
2018-11-04 16:00:00,153,129,11,11,11,70,247,11,643
2018-11-04 17:00:00,236,94,11,0,11,11,94,23,480
2018-11-04 18:00:00,94,0,11,0,0,11,23,11,150
2018-11-04 19:00:00,35,23,0,11,11,0,11,0,91
2018-11-04 20:00:00,0,11,0,11,0,0,23,0,45
2018-11-04 21:00:00,47,11,0,0,0,11,23,0,92
2018-11-04 22:00:00,11,0,0,0,0,0,23,0,34
2018-11-04 23:00:00,11,0,0,0,0,0,0,0,11
2018-11-05 00:00:00,0,0,0,0,0,0,0,0,0
2018-11-05 01:00:00,0,0,0,0,0,0,0,0,0
2018-11-05 02:00:00,0,0,0,0,0,0,0,0,0
2018-11-05 03:00:00,0,0,0,0,0,0,0,0,0
2018-11-05 04:00:00,11,0,0,0,0,0,0,0,11
2018-11-05 05:00:00,11,0,0,0,0,0,11,0,22
2018-11-05 06:00:00,106,0,0,11,0,0,0,11,128
2018-11-05 07:00:00,212,59,0,11,0,0,35,35,352
2018-11-05 08:00:00,200,23,0,11,0,0,11,118,363
2018-11-05 09:00:00,82,35,0,11,0,35,47,23,233
2018-11-05 10:00:00,141,0,23,0,0,0,82,70,316
2018-11-05 11:00:00,94,11,0,0,11,11,23,59,209
2018-11-05 12:00:00,153,11,35,0,23,23,129,35,409
2018-11-05 13:00:00,106,82,0,0,11,0,118,0,317
2018-11-05 14:00:00,259,59,0,0,11,35,118,47,529
2018-11-05 15:00:00,153,70,23,0,11,11,153,47,468
2018-11-05 16:00:00,188,23,0,11,0,0,82,11,315
2018-11-05 17:00:00,200,59,0,11,0,0,47,11,328
2018-11-05 18:00:00,188,35,0,0,11,0,47,0,281
2018-11-05 19:00:00,11,11,11,0,0,11,35,0,79
2018-11-05 20:00:00,47,35,0,0,0,0,11,11,104
2018-11-05 21:00:00,11,0,0,0,0,0,0,0,11
2018-11-05 22:00:00,0,0,0,0,0,0,0,0,0
2018-11-05 23:00:00,0,0,0,0,0,0,11,0,11
2018-11-06 00:00:00,11,0,0,0,0,0,0,0,11
2018-11-06 01:00:00,11,0,0,0,0,0,0,0,11
2018-11-06 02:00:00,0,0,0,0,0,0,0,0,0
2018-11-06 03:00:00,0,0,0,0,0,0,11,0,11
2018-11-06 04:00:00,11,0,0,0,0,0,0,0,11
2018-11-06 05:00:00,23,0,0,0,0,0,0,0,23
2018-11-06 06:00:00,70,0,0,11,0,0,23,23,127
2018-11-06 07:00:00,153,23,0,0,0,0,59,82,317
2018-11-06 08:00:00,259,47,0,0,11,0,47,94,458
2018-11-06 09:00:00,70,11,0,0,0,0,35,23,139
2018-11-06 10:00:00,212,47,0,0,0,0,94,59,412
2018-11-06 11:00:00,118,23,0,0,11,35,118,11,316
2018-11-06 12:00:00,129,35,0,0,11,11,342,70,598
2018-11-06 13:00:00,94,118,0,11,11,59,129,11,433
2018-11-06 14:00:00,224,129,0,0,11,11,165,47,587
2018-11-06 15:00:00,389,59,0,0,23,11,82,35,599
2018-11-06 16:00:00,94,35,0,0,0,35,82,0,246
2018-11-06 17:00:00,200,35,0,0,0,23,47,35,340
2018-11-06 18:00:00,94,47,0,0,23,0,35,23,222
2018-11-06 19:00:00,82,70,0,0,35,70,59,23,339
2018-11-06 20:00:00,94,23,0,0,11,59,59,11,257
2018-11-06 21:00:00,35,23,0,11,47,23,23,0,162
2018-11-06 22:00:00,11,0,0,0,11,11,0,0,33
2018-11-06 23:00:00,11,0,0,0,0,0,11,0,22
2018-11-07 00:00:00,0,0,0,0,0,23,0,0,23
2018-11-07 01:00:00,0,0,0,0,0,11,11,0,22
2018-11-07 02:00:00,0,0,0,0,0,0,23,0,23
2018-11-07 03:00:00,0,0,0,0,0,0,0,0,0
2018-11-07 04:00:00,0,0,0,0,0,0,11,0,11
2018-11-07 05:00:00,23,0,0,0,0,11,11,0,45
2018-11-07 06:00:00,82,0,0,0,0,0,0,11,93
2018-11-07 07:00:00,259,47,11,11,0,0,35,23,386
2018-11-07 08:00:00,59,35,0,0,0,11,0,59,164
2018-11-07 09:00:00,82,35,11,0,0,23,23,11,185
2018-11-07 10:00:00,200,11,0,23,11,11,129,59,444
2018-11-07 11:00:00,365,35,11,0,0,59,200,23,693
2018-11-07 12:00:00,200,59,0,35,0,11,94,0,399
2018-11-07 13:00:00,188,23,11,11,0,23,118,11,385
2018-11-07 14:00:00,188,59,11,0,0,11,59,59,387
2018-11-07 15:00:00,259,0,0,0,11,47,35,23,375
2018-11-07 16:00:00,165,47,0,11,0,0,82,47,352
2018-11-07 17:00:00,94,0,0,0,0,23,106,23,246
2018-11-07 18:00:00,82,23,23,0,11,11,47,11,208
2018-11-07 19:00:00,129,11,0,0,23,47,106,23,339
2018-11-07 20:00:00,35,0,0,23,11,23,23,0,115
2018-11-07 21:00:00,23,0,0,0,0,0,47,0,70
2018-11-07 22:00:00,35,11,0,0,0,0,59,11,116
2018-11-07 23:00:00,11,11,0,35,11,0,35,0,103
2018-11-08 00:00:00,11,0,0,0,0,0,11,0,22
2018-11-08 01:00:00,11,0,0,0,0,0,0,0,11
2018-11-08 02:00:00,0,0,0,0,0,0,0,0,0
2018-11-08 03:00:00,0,0,0,0,0,0,0,0,0
2018-11-08 04:00:00,0,0,0,0,0,0,0,0,0
2018-11-08 05:00:00,23,0,0,0,0,0,0,0,23
2018-11-08 06:00:00,70,11,0,0,0,23,23,0,127
2018-11-08 07:00:00,141,23,23,0,0,11,35,35,268
2018-11-08 08:00:00,118,118,11,0,0,0,35,82,364
2018-11-08 09:00:00,106,11,11,11,0,0,23,11,173
2018-11-08 10:00:00,165,59,11,0,11,47,59,47,399
2018-11-08 11:00:00,94,47,0,0,23,47,94,0,305
2018-11-08 12:00:00,200,118,11,0,23,59,82,11,504
2018-11-08 13:00:00,153,94,0,0,0,35,106,35,423
2018-11-08 14:00:00,188,59,11,11,23,70,94,35,491
2018-11-08 15:00:00,330,23,11,0,0,0,153,23,540
2018-11-08 16:00:00,153,23,0,11,0,35,59,0,281
2018-11-08 17:00:00,106,11,11,0,0,0,47,0,175
2018-11-08 18:00:00,106,35,0,0,0,11,11,0,163
2018-11-08 19:00:00,106,11,23,0,11,0,35,11,197
2018-11-08 20:00:00,0,23,23,0,0,35,0,11,92
2018-11-08 21:00:00,59,0,0,0,0,23,23,0,105
2018-11-08 22:00:00,59,11,0,0,0,23,47,0,140
2018-11-08 23:00:00,11,0,0,0,0,35,0,11,57
2018-11-09 00:00:00,11,0,0,0,0,11,11,0,33
2018-11-09 01:00:00,11,23,0,0,0,0,0,0,34
2018-11-09 02:00:00,11,11,0,0,0,35,0,0,57
2018-11-09 03:00:00,0,0,0,0,0,0,11,0,11
2018-11-09 04:00:00,0,0,0,0,0,0,0,0,0
2018-11-09 05:00:00,11,0,0,0,0,0,0,0,11
2018-11-09 06:00:00,70,11,0,0,0,11,11,23,126
2018-11-09 07:00:00,82,23,0,0,0,23,70,11,209
2018-11-09 08:00:00,106,35,11,0,0,0,0,59,211
2018-11-09 09:00:00,82,47,0,0,0,0,35,35,199
2018-11-09 10:00:00,94,35,0,0,23,0,59,11,222
2018-11-09 11:00:00,82,35,35,0,0,23,165,11,351
2018-11-09 12:00:00,94,94,0,0,11,23,118,35,375
2018-11-09 13:00:00,153,188,23,0,11,0,118,0,493
2018-11-09 14:00:00,177,106,0,23,35,11,94,70,516
2018-11-09 15:00:00,153,82,0,0,0,35,94,11,375
2018-11-09 16:00:00,153,70,0,0,11,11,106,23,374
2018-11-09 17:00:00,129,23,0,11,11,59,47,70,350
2018-11-09 18:00:00,165,0,0,0,0,35,82,23,305
2018-11-09 19:00:00,70,47,0,11,35,70,23,0,256
2018-11-09 20:00:00,47,106,0,0,11,70,59,47,340
2018-11-09 21:00:00,35,35,0,0,0,35,23,0,128
2018-11-09 22:00:00,0,23,0,11,23,23,59,0,139
2018-11-09 23:00:00,23,11,0,0,0,11,35,0,80
2018-11-10 00:00:00,11,0,0,0,0,11,0,0,22
2018-11-10 01:00:00,23,0,0,0,0,11,0,11,45
2018-11-10 02:00:00,23,11,0,0,0,0,0,23,57
2018-11-10 03:00:00,0,0,0,0,0,11,0,0,11
2018-11-10 04:00:00,0,0,0,0,0,11,0,0,11
2018-11-10 05:00:00,0,0,0,0,0,0,0,0,0
2018-11-10 06:00:00,0,0,0,0,0,0,0,11,11
2018-11-10 07:00:00,23,0,11,0,0,0,0,0,34
2018-11-10 08:00:00,23,0,0,0,0,0,35,0,58
2018-11-10 09:00:00,59,35,0,23,0,23,70,23,233
2018-11-10 10:00:00,47,11,0,23,23,23,94,0,221
2018-11-10 11:00:00,141,129,11,11,11,59,141,47,550
2018-11-10 12:00:00,177,94,23,70,70,129,330,106,999
2018-11-10 13:00:00,177,295,23,106,82,118,542,35,1378
2018-11-10 14:00:00,224,177,0,47,47,129,448,23,1095
2018-11-10 15:00:00,295,82,0,23,23,47,118,11,599
2018-11-10 16:00:00,118,59,0,0,11,35,106,0,329
2018-11-10 17:00:00,118,0,11,35,11,23,106,0,304
2018-11-10 18:00:00,82,0,11,23,0,0,47,0,163
2018-11-10 19:00:00,82,23,0,35,11,47,23,11,232
2018-11-10 20:00:00,11,11,0,11,0,23,23,0,79
2018-11-10 21:00:00,35,11,0,0,0,0,23,0,69
2018-11-10 22:00:00,59,0,0,0,0,0,106,0,165
2018-11-10 23:00:00,11,0,0,0,0,0,23,0,34
2018-11-11 00:00:00,0,0,0,0,0,0,35,0,35
2018-11-11 01:00:00,11,0,0,0,0,0,0,0,11
2018-11-11 02:00:00,35,0,0,0,0,0,0,0,35
2018-11-11 03:00:00,0,0,0,0,0,0,23,0,23
2018-11-11 04:00:00,0,0,0,0,0,0,0,0,0
2018-11-11 05:00:00,0,0,0,0,11,0,0,0,11
2018-11-11 06:00:00,11,0,0,0,0,0,11,0,22
2018-11-11 07:00:00,0,0,0,0,0,0,11,0,11
2018-11-11 08:00:00,0,0,0,0,0,0,35,0,35
2018-11-11 09:00:00,0,11,0,0,0,0,23,0,34
2018-11-11 10:00:00,106,35,0,0,11,11,47,0,210
2018-11-11 11:00:00,47,35,0,0,0,0,82,0,164
2018-11-11 12:00:00,35,11,0,0,0,35,129,0,210
2018-11-11 13:00:00,59,59,11,0,47,47,82,11,316
2018-11-11 14:00:00,47,82,11,0,0,47,129,0,316
2018-11-11 15:00:00,47,47,0,11,23,11,106,0,245
2018-11-11 16:00:00,47,35,0,0,0,0,82,0,164
2018-11-11 17:00:00,47,11,0,0,11,0,47,0,116
2018-11-11 18:00:00,23,11,0,0,0,0,11,0,45
2018-11-11 19:00:00,35,47,0,0,0,11,11,0,104
2018-11-11 20:00:00,0,11,0,0,0,11,11,0,33
2018-11-11 21:00:00,11,0,0,0,11,11,35,0,68
2018-11-11 22:00:00,11,0,0,0,0,0,11,0,22
2018-11-11 23:00:00,11,0,0,0,0,23,0,0,34
2018-11-12 00:00:00,0,11,0,0,0,0,0,0,11
2018-11-12 01:00:00,0,0,0,0,0,0,0,0,0
2018-11-12 02:00:00,0,0,0,0,0,0,23,0,23
2018-11-12 03:00:00,0,0,0,0,0,0,11,0,11
2018-11-12 04:00:00,0,0,0,0,0,0,11,0,11
2018-11-12 05:00:00,0,0,0,0,0,0,23,0,23
2018-11-12 06:00:00,82,0,0,11,11,0,23,0,127
2018-11-12 07:00:00,141,11,11,11,11,11,94,0,290
2018-11-12 08:00:00,82,11,0,11,11,23,106,0,244
2018-11-12 09:00:00,94,70,11,0,23,11,47,11,267
2018-11-12 10:00:00,59,47,35,0,23,0,11,0,175
2018-11-12 11:00:00,495,70,23,0,11,23,153,0,775
2018-11-12 12:00:00,153,94,35,11,23,82,177,0,575
2018-11-12 13:00:00,188,106,47,23,35,23,448,0,870
2018-11-12 14:00:00,200,47,23,11,0,47,212,0,540
2018-11-12 15:00:00,719,82,35,0,47,82,165,0,1130
2018-11-12 16:00:00,129,47,23,0,0,47,47,0,293
2018-11-12 17:00:00,247,23,11,0,0,59,35,0,375
2018-11-12 18:00:00,118,23,0,0,0,23,59,0,223
2018-11-12 19:00:00,129,35,0,0,11,35,47,0,257
2018-11-12 20:00:00,11,23,0,0,11,11,35,0,91
2018-11-12 21:00:00,11,0,0,0,11,0,11,0,33
2018-11-12 22:00:00,23,0,0,0,0,0,23,0,46
2018-11-12 23:00:00,11,0,0,0,0,0,0,0,11
2018-11-13 00:00:00,0,0,0,0,0,0,0,0,0
2018-11-13 01:00:00,0,0,0,0,0,0,0,0,0
2018-11-13 02:00:00,0,0,0,0,0,0,0,0,0
2018-11-13 03:00:00,0,0,0,0,0,0,0,0,0
2018-11-13 04:00:00,11,0,0,0,0,0,0,0,11
2018-11-13 05:00:00,11,0,0,0,0,0,0,0,11
2018-11-13 06:00:00,11,0,0,0,0,0,11,0,22
2018-11-13 07:00:00,165,23,0,0,0,0,70,11,269
2018-11-13 08:00:00,94,11,23,0,23,0,47,94,292
2018-11-13 09:00:00,94,11,23,0,11,0,11,11,161
2018-11-13 10:00:00,59,11,0,11,0,23,106,0,210
2018-11-13 11:00:00,82,59,11,11,23,35,82,23,326
2018-11-13 12:00:00,94,0,35,0,11,0,47,35,222
2018-11-13 13:00:00,94,59,0,0,0,35,82,11,281
2018-11-13 14:00:00,106,82,11,0,11,0,94,35,339
2018-11-13 15:00:00,247,0,11,11,11,23,47,59,409
2018-11-13 16:00:00,59,11,0,0,0,11,47,11,139
2018-11-13 17:00:00,47,11,0,0,0,0,59,0,117
2018-11-13 18:00:00,47,35,11,0,0,11,35,35,174
2018-11-13 19:00:00,47,47,0,0,0,0,59,0,153
2018-11-13 20:00:00,70,35,0,0,0,35,47,0,187
2018-11-13 21:00:00,23,59,0,11,11,11,94,0,209
2018-11-13 22:00:00,47,0,0,0,0,11,0,0,58
2018-11-13 23:00:00,0,0,0,0,0,0,23,0,23
2018-11-14 00:00:00,23,0,0,0,0,0,11,0,34
2018-11-14 01:00:00,0,0,0,0,0,0,0,0,0
2018-11-14 02:00:00,0,0,0,0,0,0,23,0,23
2018-11-14 03:00:00,0,0,0,0,0,0,11,0,11
2018-11-14 04:00:00,0,0,0,0,0,0,11,0,11
2018-11-14 05:00:00,23,0,0,0,0,0,0,0,23
2018-11-14 06:00:00,82,0,0,0,0,0,23,23,128
2018-11-14 07:00:00,82,23,0,0,0,11,23,35,174
2018-11-14 08:00:00,106,0,0,0,0,0,47,59,212
2018-11-14 09:00:00,59,11,0,0,70,0,70,23,233
2018-11-14 10:00:00,188,23,23,0,0,23,177,0,434
2018-11-14 11:00:00,11,47,0,11,11,35,165,11,291
2018-11-14 12:00:00,177,59,47,47,70,82,177,23,682
2018-11-14 13:00:00,106,59,11,0,35,35,224,0,470
2018-11-14 14:00:00,177,35,23,11,47,59,94,59,505
2018-11-14 15:00:00,236,59,11,0,23,23,153,0,505
2018-11-14 16:00:00,118,94,0,0,11,35,141,23,422
2018-11-14 17:00:00,82,11,0,0,11,11,165,47,327
2018-11-14 18:00:00,129,47,11,11,23,23,94,11,349
2018-11-14 19:00:00,82,23,0,0,0,47,23,11,186
2018-11-14 20:00:00,59,0,0,23,23,11,59,0,175
2018-11-14 21:00:00,94,0,0,0,0,11,23,0,128
2018-11-14 22:00:00,118,0,0,0,0,11,82,0,211
2018-11-14 23:00:00,47,11,0,0,11,47,35,0,151
2018-11-15 00:00:00,11,0,0,0,0,0,0,0,11
2018-11-15 01:00:00,11,0,0,0,0,0,0,11,22
2018-11-15 02:00:00,23,0,0,0,0,0,11,0,34
2018-11-15 03:00:00,0,0,0,0,0,0,35,0,35
2018-11-15 04:00:00,11,0,0,0,0,0,0,0,11
2018-11-15 05:00:00,23,0,0,0,0,0,11,0,34
2018-11-15 06:00:00,35,11,0,0,0,0,59,0,105
2018-11-15 07:00:00,153,0,0,0,0,0,47,23,223
2018-11-15 08:00:00,94,23,0,0,0,0,35,106,258
2018-11-15 09:00:00,188,11,0,0,11,11,47,47,315
2018-11-15 10:00:00,118,35,23,0,23,11,82,0,292
2018-11-15 11:00:00,129,59,11,0,0,82,118,0,399
2018-11-15 12:00:00,177,59,11,0,0,11,129,35,422
2018-11-15 13:00:00,200,47,11,0,0,0,47,23,328
2018-11-15 14:00:00,731,59,11,11,23,11,129,82,1057
2018-11-15 15:00:00,129,82,0,0,11,35,70,23,350
2018-11-15 16:00:00,141,35,0,0,23,11,70,23,303
2018-11-15 17:00:00,153,59,0,0,0,0,70,11,293
2018-11-15 18:00:00,153,23,0,0,35,23,59,11,304
2018-11-15 19:00:00,59,59,0,0,23,47,11,0,199
2018-11-15 20:00:00,23,47,0,0,11,11,0,11,103
2018-11-15 21:00:00,35,23,0,11,11,0,59,0,139
2018-11-15 22:00:00,23,11,0,0,0,0,11,0,45
2018-11-15 23:00:00,11,0,0,0,0,0,0,0,11
2018-11-16 00:00:00,23,0,0,0,0,11,0,0,34
2018-11-16 01:00:00,0,0,0,0,0,0,0,0,0
2018-11-16 02:00:00,0,0,0,0,0,0,0,0,0
2018-11-16 03:00:00,23,0,0,0,0,0,11,0,34
2018-11-16 04:00:00,11,23,0,0,0,0,0,0,34
2018-11-16 05:00:00,11,0,0,0,0,0,23,0,34
2018-11-16 06:00:00,59,11,0,0,0,0,23,0,93
2018-11-16 07:00:00,118,0,0,0,11,11,70,35,245
2018-11-16 08:00:00,118,23,0,0,0,11,70,35,257
2018-11-16 09:00:00,47,23,0,0,11,23,11,0,115
2018-11-16 10:00:00,94,59,0,11,11,0,118,0,293
2018-11-16 11:00:00,82,59,0,0,0,23,59,11,234
2018-11-16 12:00:00,188,82,0,70,47,23,129,35,574
2018-11-16 13:00:00,165,70,0,0,0,82,153,70,540
2018-11-16 14:00:00,129,165,0,0,35,94,153,35,611
2018-11-16 15:00:00,306,59,11,0,0,11,177,118,682
2018-11-16 16:00:00,82,0,0,0,35,47,177,35,376
2018-11-16 17:00:00,47,11,0,0,0,0,82,11,151
2018-11-16 18:00:00,0,0,0,0,0,0,35,0,35
2018-11-16 19:00:00,11,0,0,0,0,0,23,0,34
2018-11-16 20:00:00,23,11,0,0,11,11,11,0,67
2018-11-16 21:00:00,0,0,0,0,0,0,0,0,0
2018-11-16 22:00:00,11,0,0,0,0,0,23,0,34
2018-11-16 23:00:00,0,0,0,0,0,0,11,0,11
2018-11-17 00:00:00,23,0,0,0,0,23,59,23,128
2018-11-17 01:00:00,59,11,0,0,11,0,35,11,127
2018-11-17 02:00:00,11,0,0,0,0,11,23,0,45
2018-11-17 03:00:00,0,11,0,0,0,0,35,0,46
2018-11-17 04:00:00,11,0,0,0,0,0,23,0,34
2018-11-17 05:00:00,11,0,0,0,0,0,47,11,69
2018-11-17 06:00:00,23,0,0,0,0,0,23,0,46
2018-11-17 07:00:00,11,0,0,0,0,0,11,11,33
2018-11-17 08:00:00,23,23,0,0,0,0,59,0,105
2018-11-17 09:00:00,94,11,11,11,11,23,94,11,266
2018-11-17 10:00:00,106,82,23,11,11,11,82,23,349
2018-11-17 11:00:00,165,141,0,47,11,11,306,35,716
2018-11-17 12:00:00,318,188,0,188,23,70,472,11,1270
2018-11-17 13:00:00,283,177,0,141,70,82,495,59,1307
2018-11-17 14:00:00,354,177,11,35,11,82,566,23,1259
2018-11-17 15:00:00,82,94,11,23,59,47,330,47,693
2018-11-17 16:00:00,165,70,23,0,35,23,165,11,492
2018-11-17 17:00:00,94,47,0,0,0,35,59,11,246
2018-11-17 18:00:00,94,0,0,0,0,0,59,0,153
2018-11-17 19:00:00,0,0,0,0,0,0,11,11,22
2018-11-17 20:00:00,11,0,0,0,0,0,11,0,22
2018-11-17 21:00:00,35,0,0,0,0,11,35,11,92
2018-11-17 22:00:00,0,0,0,0,0,0,0,0,0
2018-11-17 23:00:00,0,0,0,0,0,0,0,0,0
2018-11-18 00:00:00,23,0,0,0,0,35,0,11,69
2018-11-18 01:00:00,35,11,0,0,0,47,23,0,116
2018-11-18 02:00:00,11,11,0,0,0,23,23,0,68
2018-11-18 03:00:00,0,11,0,0,0,0,11,0,22
2018-11-18 04:00:00,0,11,0,0,0,0,0,0,11
2018-11-18 05:00:00,11,11,0,0,0,0,0,11,33
2018-11-18 06:00:00,23,11,0,0,0,0,11,0,45
2018-11-18 07:00:00,11,11,0,0,0,11,47,0,80
2018-11-18 08:00:00,0,23,0,0,0,11,47,0,81
2018-11-18 09:00:00,0,35,11,0,11,0,82,0,139
2018-11-18 10:00:00,23,47,0,0,0,0,70,23,163
2018-11-18 11:00:00,129,94,0,23,47,106,177,35,611
2018-11-18 12:00:00,153,106,11,23,11,153,389,94,940
2018-11-18 13:00:00,118,283,23,11,47,177,920,70,1649
2018-11-18 14:00:00,200,259,35,11,47,129,625,23,1329
2018-11-18 15:00:00,177,118,23,47,59,70,483,35,1012
2018-11-18 16:00:00,70,23,11,11,11,23,177,0,326
2018-11-18 17:00:00,35,11,11,11,0,0,129,23,220
2018-11-18 18:00:00,59,0,0,0,0,0,35,11,105
2018-11-18 19:00:00,0,0,0,0,0,0,23,0,23
2018-11-18 20:00:00,23,0,0,0,0,0,47,0,70
2018-11-18 21:00:00,23,0,11,0,0,0,35,23,92
2018-11-18 22:00:00,0,11,0,0,0,0,23,0,34
2018-11-18 23:00:00,11,0,0,0,0,0,35,0,46
2018-11-19 00:00:00,23,0,0,0,0,0,11,0,34
2018-11-19 01:00:00,11,0,0,0,0,0,0,0,11
2018-11-19 02:00:00,0,0,0,0,0,0,0,0,0
2018-11-19 03:00:00,0,0,0,0,0,0,23,0,23
2018-11-19 04:00:00,11,0,0,0,0,0,0,0,11
2018-11-19 05:00:00,11,0,0,0,0,0,23,0,34
2018-11-19 06:00:00,47,11,0,11,11,0,23,0,103
2018-11-19 07:00:00,177,11,0,0,11,11,47,23,280
2018-11-19 08:00:00,129,35,0,11,0,11,70,70,326
2018-11-19 09:00:00,59,35,11,0,11,11,35,0,162
2018-11-19 10:00:00,82,11,47,0,11,23,82,0,256
2018-11-19 11:00:00,59,11,11,0,0,11,94,23,209
2018-11-19 12:00:00,82,11,11,0,11,35,94,11,255
2018-11-19 13:00:00,177,59,47,0,11,23,165,23,505
2018-11-19 14:00:00,165,47,35,0,47,47,141,106,588
2018-11-19 15:00:00,271,70,47,0,35,35,177,23,658
2018-11-19 16:00:00,212,23,0,0,23,0,11,23,292
2018-11-19 17:00:00,70,35,0,0,11,23,106,0,245
2018-11-19 18:00:00,106,23,0,11,11,11,59,0,221
2018-11-19 19:00:00,35,35,11,0,0,0,70,23,174
2018-11-19 20:00:00,23,0,0,0,0,0,47,11,81
2018-11-19 21:00:00,35,0,0,0,0,0,47,0,82
2018-11-19 22:00:00,11,0,0,0,0,0,11,0,22
2018-11-19 23:00:00,35,0,0,0,0,0,23,0,58
2018-11-20 00:00:00,0,0,0,0,0,0,23,0,23
2018-11-20 01:00:00,0,0,0,0,0,0,35,0,35
2018-11-20 02:00:00,0,0,0,0,0,0,0,0,0
2018-11-20 03:00:00,0,0,0,0,0,0,0,0,0
2018-11-20 04:00:00,0,0,0,0,0,11,11,0,22
2018-11-20 05:00:00,59,0,0,0,11,0,23,0,93
2018-11-20 06:00:00,82,0,0,11,0,0,35,23,151
2018-11-20 07:00:00,200,0,0,0,11,23,11,35,280
2018-11-20 08:00:00,94,11,35,0,0,11,35,35,221
2018-11-20 09:00:00,82,35,11,0,0,11,94,0,233
2018-11-20 10:00:00,70,23,11,0,35,47,59,11,256
2018-11-20 11:00:00,94,11,0,0,47,47,177,59,435
2018-11-20 12:00:00,212,11,0,0,23,35,200,59,540
2018-11-20 13:00:00,118,23,23,11,23,153,141,23,515
2018-11-20 14:00:00,177,59,35,11,0,11,141,82,516
2018-11-20 15:00:00,129,47,35,0,23,11,141,35,421
2018-11-20 16:00:00,70,23,11,11,0,11,106,0,232
2018-11-20 17:00:00,70,0,0,0,11,23,47,0,151
2018-11-20 18:00:00,82,59,47,0,47,11,106,11,363
2018-11-20 19:00:00,47,47,11,0,0,11,35,11,162
2018-11-20 20:00:00,23,23,23,0,0,0,23,11,103
2018-11-20 21:00:00,35,11,0,0,0,0,23,0,69
2018-11-20 22:00:00,23,0,0,0,0,0,0,0,23
2018-11-20 23:00:00,11,0,0,0,0,0,11,0,22
2018-11-21 00:00:00,23,0,0,0,0,0,0,0,23
2018-11-21 01:00:00,0,0,0,0,0,0,0,0,0
2018-11-21 02:00:00,0,0,0,0,0,0,0,0,0
2018-11-21 03:00:00,0,0,0,0,0,11,0,0,11
2018-11-21 04:00:00,0,0,0,0,0,0,0,0,0
2018-11-21 05:00:00,23,0,0,0,0,0,0,0,23
2018-11-21 06:00:00,70,11,0,0,0,11,0,11,103
2018-11-21 07:00:00,141,11,0,23,0,0,23,23,221
2018-11-21 08:00:00,106,47,11,0,11,0,47,35,257
2018-11-21 09:00:00,106,35,23,11,0,23,106,11,315
2018-11-21 10:00:00,212,11,23,11,23,82,153,47,562
2018-11-21 11:00:00,47,70,11,0,0,0,165,11,304
2018-11-21 12:00:00,212,70,11,0,23,59,141,11,527
2018-11-21 13:00:00,188,70,23,0,11,35,141,23,491
2018-11-21 14:00:00,212,59,11,0,0,47,70,165,564
2018-11-21 15:00:00,212,82,35,0,11,47,70,23,480
2018-11-21 16:00:00,47,35,11,0,0,47,70,35,245
2018-11-21 17:00:00,70,47,0,0,11,23,35,11,197
2018-11-21 18:00:00,94,59,35,0,0,23,70,11,292
2018-11-21 19:00:00,94,35,23,0,11,0,23,11,197
2018-11-21 20:00:00,82,11,0,0,11,11,35,0,150
2018-11-21 21:00:00,70,0,59,0,0,0,35,11,175
2018-11-21 22:00:00,11,23,0,0,11,0,11,0,56
2018-11-21 23:00:00,0,0,0,0,0,0,0,0,0
2018-11-22 00:00:00,11,23,0,0,0,0,0,0,34
2018-11-22 01:00:00,23,0,0,0,0,11,0,0,34
2018-11-22 02:00:00,0,35,0,0,0,0,11,0,46
2018-11-22 03:00:00,0,11,0,0,0,0,0,0,11
2018-11-22 04:00:00,0,23,0,0,0,0,0,0,23
2018-11-22 05:00:00,35,11,0,0,0,0,35,0,81
2018-11-22 06:00:00,94,23,0,11,11,0,0,0,139
2018-11-22 07:00:00,177,35,0,0,0,23,23,47,305
2018-11-22 08:00:00,318,59,23,0,11,11,11,94,527
2018-11-22 09:00:00,118,59,0,0,0,11,35,0,223
2018-11-22 10:00:00,118,35,11,23,23,0,82,59,351
2018-11-22 11:00:00,82,47,11,11,11,23,70,23,278
2018-11-22 12:00:00,188,23,23,11,11,23,118,11,408
2018-11-22 13:00:00,141,59,35,0,11,0,129,11,386
2018-11-22 14:00:00,295,35,59,0,0,23,118,35,565
2018-11-22 15:00:00,82,23,59,0,11,23,153,0,351
2018-11-22 16:00:00,106,460,0,11,11,70,106,11,775
2018-11-22 17:00:00,129,23,0,0,11,11,59,11,244
2018-11-22 18:00:00,47,0,0,0,0,11,11,0,69
2018-11-22 19:00:00,11,0,0,0,0,23,11,11,56
2018-11-22 20:00:00,0,0,0,0,0,0,11,0,11
2018-11-22 21:00:00,11,0,0,11,0,0,11,0,33
2018-11-22 22:00:00,0,0,0,0,0,0,0,0,0
2018-11-22 23:00:00,0,0,0,0,0,0,0,0,0
2018-11-23 00:00:00,0,0,0,0,0,0,0,0,0
2018-11-23 01:00:00,0,0,0,0,0,0,0,0,0
2018-11-23 02:00:00,0,0,0,0,0,0,0,0,0
2018-11-23 03:00:00,0,0,0,0,0,0,0,0,0
2018-11-23 04:00:00,0,0,0,0,0,0,0,0,0
2018-11-23 05:00:00,0,0,0,0,0,0,0,0,0
2018-11-23 06:00:00,0,0,0,0,0,0,0,0,0
2018-11-23 07:00:00,224,35,11,47,0,11,47,0,375
2018-11-23 08:00:00,118,35,0,47,0,11,70,70,351
2018-11-23 09:00:00,23,35,11,35,23,0,70,0,197
2018-11-23 10:00:00,129,35,47,35,23,11,59,23,362
2018-11-23 11:00:00,129,70,70,35,11,11,82,11,419
2018-11-23 12:00:00,200,35,47,0,23,11,82,23,421
2018-11-23 13:00:00,82,35,11,0,11,23,59,23,244
2018-11-23 14:00:00,177,35,59,0,11,35,47,59,423
2018-11-23 15:00:00,35,0,11,0,0,0,23,0,69
2018-11-23 16:00:00,11,11,0,0,0,11,0,0,33
2018-11-23 17:00:00,11,0,0,0,0,0,23,0,34
2018-11-23 18:00:00,11,0,0,0,0,0,11,0,22
2018-11-23 19:00:00,0,0,0,0,0,0,0,0,0
2018-11-23 20:00:00,0,0,0,0,11,0,11,0,22
2018-11-23 21:00:00,0,0,0,0,0,0,0,0,0
2018-11-23 22:00:00,0,0,0,0,0,0,0,0,0
2018-11-23 23:00:00,0,0,0,0,0,0,0,0,0
2018-11-24 00:00:00,0,35,0,0,0,0,0,0,35
2018-11-24 01:00:00,0,0,0,0,0,0,0,0,0
2018-11-24 02:00:00,0,0,0,0,0,0,35,0,35
2018-11-24 03:00:00,0,0,0,0,0,0,11,0,11
2018-11-24 04:00:00,0,0,0,0,0,0,23,0,23
2018-11-24 05:00:00,0,0,0,0,0,0,0,0,0
2018-11-24 06:00:00,23,0,0,0,0,0,23,0,46
2018-11-24 07:00:00,47,0,0,0,11,0,11,0,69
2018-11-24 08:00:00,82,0,0,0,0,11,82,11,186
2018-11-24 09:00:00,35,23,0,0,23,23,59,35,198
2018-11-24 10:00:00,0,0,0,0,0,23,70,35,128
2018-11-24 11:00:00,11,0,0,0,0,0,47,0,58
2018-11-24 12:00:00,0,0,11,0,11,35,11,0,68
2018-11-24 13:00:00,0,0,0,0,0,0,11,35,46
2018-11-24 14:00:00,11,0,0,0,0,0,35,0,46
2018-11-24 15:00:00,23,0,0,0,0,0,23,0,46
2018-11-24 16:00:00,23,0,0,0,0,0,0,0,23
2018-11-24 17:00:00,23,0,0,0,0,0,0,0,23
2018-11-24 18:00:00,0,0,0,0,0,0,0,0,0
2018-11-24 19:00:00,0,0,0,0,0,0,0,0,0
2018-11-24 20:00:00,0,0,0,0,0,0,0,0,0
2018-11-24 21:00:00,0,0,0,0,0,0,0,0,0
2018-11-24 22:00:00,0,0,0,0,0,0,0,0,0
2018-11-24 23:00:00,0,0,0,0,0,0,0,0,0
2018-11-25 00:00:00,35,35,0,0,23,0,59,0,152
2018-11-25 01:00:00,35,11,59,0,47,0,23,0,175
2018-11-25 02:00:00,11,11,11,0,35,0,94,0,162
2018-11-25 03:00:00,0,23,0,0,0,0,23,0,46
2018-11-25 04:00:00,0,11,0,0,0,0,23,0,34
2018-11-25 05:00:00,0,11,0,0,0,0,35,0,46
2018-11-25 06:00:00,23,11,0,0,0,0,47,11,92
2018-11-25 07:00:00,11,35,0,0,0,0,82,0,128
2018-11-25 08:00:00,0,11,0,0,0,0,59,0,70
2018-11-25 09:00:00,23,23,11,0,0,0,47,0,104
2018-11-25 10:00:00,70,35,59,0,47,11,118,11,351
2018-11-25 11:00:00,11,0,47,0,0,0,118,0,176
2018-11-25 12:00:00,70,0,0,0,0,0,70,0,140
2018-11-25 13:00:00,47,0,0,0,0,0,129,0,176
2018-11-25 14:00:00,11,0,0,0,0,0,47,0,58
2018-11-25 15:00:00,59,0,0,0,11,0,23,0,93
2018-11-25 16:00:00,11,11,0,0,0,0,35,0,57
2018-11-25 17:00:00,0,0,0,0,0,0,0,11,11
2018-11-25 18:00:00,0,11,0,0,0,0,0,0,11
2018-11-25 19:00:00,0,0,0,0,0,0,0,0,0
2018-11-25 20:00:00,0,0,0,0,0,0,0,0,0
2018-11-25 21:00:00,0,0,0,0,0,0,0,0,0
2018-11-25 22:00:00,0,0,0,0,0,0,0,0,0
2018-11-25 23:00:00,0,0,0,0,0,0,0,0,0
2018-11-26 00:00:00,0,0,0,0,0,0,0,0,0
2018-11-26 01:00:00,23,0,0,0,0,0,0,0,23
2018-11-26 02:00:00,0,0,0,0,0,0,0,0,0
2018-11-26 03:00:00,0,0,0,0,11,11,23,0,45
2018-11-26 04:00:00,0,0,0,0,0,0,0,0,0
2018-11-26 05:00:00,11,0,0,0,0,11,11,0,33
2018-11-26 06:00:00,70,23,0,0,0,0,35,0,128
2018-11-26 07:00:00,188,23,0,0,0,23,118,94,446
2018-11-26 08:00:00,200,35,70,0,35,0,82,106,528
2018-11-26 09:00:00,70,47,35,0,47,0,129,70,398
2018-11-26 10:00:00,118,35,11,0,11,47,165,59,446
2018-11-26 11:00:00,82,47,11,0,11,35,188,59,433
2018-11-26 12:00:00,129,35,0,11,0,23,70,59,327
2018-11-26 13:00:00,11,11,59,11,0,0,94,11,197
2018-11-26 14:00:00,94,23,47,0,0,35,106,23,328
2018-11-26 15:00:00,35,11,11,0,0,11,35,0,103
2018-11-26 16:00:00,0,0,0,0,0,0,23,11,34
2018-11-26 17:00:00,0,0,0,0,0,0,59,0,59
2018-11-26 18:00:00,0,0,0,0,0,0,11,0,11
2018-11-26 19:00:00,0,0,0,0,0,0,0,0,0
2018-11-26 20:00:00,0,0,0,0,0,0,0,0,0
2018-11-26 21:00:00,0,0,0,0,0,0,0,0,0
2018-11-26 22:00:00,0,0,0,0,0,0,0,0,0
2018-11-26 23:00:00,0,0,0,0,0,0,0,0,0
2018-11-27 00:00:00,0,0,0,0,0,0,23,0,23
2018-11-27 01:00:00,0,0,0,0,0,0,0,0,0
2018-11-27 02:00:00,0,0,0,0,0,0,0,0,0
2018-11-27 03:00:00,0,0,0,0,11,0,0,0,11
2018-11-27 04:00:00,0,0,0,0,0,0,11,0,11
2018-11-27 05:00:00,11,0,0,0,0,11,35,11,68
2018-11-27 06:00:00,59,11,0,0,0,0,23,11,104
2018-11-27 07:00:00,153,59,0,23,11,0,106,23,375
2018-11-27 08:00:00,129,23,11,11,23,11,82,23,313
2018-11-27 09:00:00,94,11,11,11,35,35,35,11,243
2018-11-27 10:00:00,70,59,0,0,23,23,94,23,292
2018-11-27 11:00:00,165,106,23,23,47,47,306,47,764
2018-11-27 12:00:00,212,82,11,35,23,59,177,47,646
2018-11-27 13:00:00,165,35,23,0,11,23,11,35,303
2018-11-27 14:00:00,82,35,0,0,0,47,35,47,246
2018-11-27 15:00:00,23,0,35,0,0,11,47,0,116
2018-11-27 16:00:00,47,11,0,0,23,0,35,0,116
2018-11-27 17:00:00,11,0,0,0,11,0,0,0,22
2018-11-27 18:00:00,0,11,0,0,0,0,11,0,22
2018-11-27 19:00:00,11,0,0,0,0,0,0,0,11
2018-11-27 20:00:00,11,11,11,0,0,0,0,0,33
2018-11-27 21:00:00,0,0,0,0,0,0,0,0,0
2018-11-27 22:00:00,11,0,0,0,0,0,0,0,11
2018-11-27 23:00:00,0,0,0,0,0,0,0,0,0
2018-11-28 00:00:00,0,0,0,0,0,0,23,0,23
2018-11-28 01:00:00,11,11,0,0,0,0,11,0,33
2018-11-28 02:00:00,0,35,0,0,0,0,11,0,46
2018-11-28 03:00:00,0,23,0,0,0,11,35,0,69
2018-11-28 04:00:00,0,23,0,0,0,0,35,0,58
2018-11-28 05:00:00,23,23,0,0,0,11,35,0,92
2018-11-28 06:00:00,70,47,0,0,0,0,59,23,199
2018-11-28 07:00:00,212,23,0,0,0,0,23,23,281
2018-11-28 08:00:00,129,70,23,0,23,47,82,118,492
2018-11-28 09:00:00,0,11,0,0,0,11,59,47,128
2018-11-28 10:00:00,0,94,11,0,11,35,106,23,280
2018-11-28 11:00:00,11,23,11,0,23,11,129,23,231
2018-11-28 12:00:00,118,35,47,23,23,11,82,47,386
2018-11-28 13:00:00,153,82,11,23,0,70,295,0,634
2018-11-28 14:00:00,212,82,11,0,0,59,129,35,528
2018-11-28 15:00:00,188,70,23,11,11,59,129,23,514
2018-11-28 16:00:00,59,35,0,0,11,47,47,35,234
2018-11-28 17:00:00,106,11,0,0,0,0,47,23,187
2018-11-28 18:00:00,70,11,0,0,0,11,82,11,185
2018-11-28 19:00:00,94,35,0,0,0,23,70,35,257
2018-11-28 20:00:00,0,0,0,0,11,0,82,0,93
2018-11-28 21:00:00,11,0,0,11,0,0,23,0,45
2018-11-28 22:00:00,59,0,0,0,0,0,23,0,82
2018-11-28 23:00:00,11,0,0,0,0,0,0,0,11
2018-11-29 00:00:00,0,0,0,47,0,23,0,0,70
2018-11-29 01:00:00,11,0,0,35,0,0,11,0,57
2018-11-29 02:00:00,11,0,0,47,0,0,23,0,81
2018-11-29 03:00:00,0,0,0,35,11,0,23,0,69
2018-11-29 04:00:00,0,0,0,47,0,0,23,11,81
2018-11-29 05:00:00,11,0,0,35,0,0,35,11,92
2018-11-29 06:00:00,0,11,0,35,0,23,35,0,104
2018-11-29 07:00:00,59,23,0,35,0,11,82,11,221
2018-11-29 08:00:00,35,23,11,59,23,0,82,47,280
2018-11-29 09:00:00,47,11,47,35,11,47,70,23,291
2018-11-29 10:00:00,23,23,11,23,0,47,47,0,174
2018-11-29 11:00:00,554,0,35,11,11,23,82,47,763
2018-11-29 12:00:00,23,0,0,23,11,70,118,0,245
2018-11-29 13:00:00,47,59,0,0,11,59,70,23,269
2018-11-29 14:00:00,118,23,0,11,35,94,129,0,410
2018-11-29 15:00:00,188,70,11,0,0,94,106,0,469
2018-11-29 16:00:00,82,11,0,0,23,35,82,0,233
2018-11-29 17:00:00,59,0,11,11,0,47,59,0,187
2018-11-29 18:00:00,94,11,11,11,23,47,82,11,290
2018-11-29 19:00:00,82,23,0,23,0,35,23,0,186
2018-11-29 20:00:00,23,11,0,0,11,0,35,0,80
2018-11-29 21:00:00,47,0,0,0,0,0,11,11,69
2018-11-29 22:00:00,94,0,0,11,23,35,11,0,174
2018-11-29 23:00:00,11,0,0,0,0,0,0,0,11
2018-11-30 00:00:00,0,0,0,0,0,0,23,11,34
2018-11-30 01:00:00,0,0,0,0,0,0,47,0,47
2018-11-30 02:00:00,0,0,0,0,0,0,11,0,11
2018-11-30 03:00:00,0,0,0,0,0,11,23,0,34
2018-11-30 04:00:00,0,0,0,0,0,0,23,0,23
2018-11-30 05:00:00,0,0,0,0,0,0,47,0,47
2018-11-30 06:00:00,47,11,0,0,0,23,35,0,116
2018-11-30 07:00:00,70,23,0,23,0,11,82,35,244
2018-11-30 08:00:00,59,35,0,23,0,11,23,35,186
2018-11-30 09:00:00,129,0,0,70,0,23,35,23,280
2018-11-30 10:00:00,0,47,23,11,23,23,82,0,209
2018-11-30 11:00:00,106,35,23,11,47,94,118,0,434
2018-11-30 12:00:00,141,59,0,11,11,35,94,35,386
2018-11-30 13:00:00,141,35,11,11,0,47,70,23,338
2018-11-30 14:00:00,82,35,11,11,11,35,129,35,349
2018-11-30 15:00:00,82,70,0,23,11,47,106,35,374
2018-11-30 16:00:00,47,11,0,0,11,0,59,0,128
2018-11-30 17:00:00,35,23,11,11,11,23,35,0,149
2018-11-30 18:00:00,165,11,11,0,11,47,141,0,386
2018-11-30 19:00:00,0,23,0,23,0,0,70,0,116
2018-11-30 20:00:00,23,0,11,0,11,23,11,0,79
2018-11-30 21:00:00,0,0,11,0,0,11,47,0,69
2018-11-30 22:00:00,0,0,0,0,23,35,35,11,104
2018-11-30 23:00:00,0,0,0,0,0,0,35,0,35
2018-12-01 00:00:00,0,0,23,0,11,23,23,0,80
2018-12-01 01:00:00,0,0,11,0,0,35,11,11,68
2018-12-01 02:00:00,0,0,11,0,0,0,0,0,11
2018-12-01 03:00:00,0,0,0,0,0,0,0,0,0
2018-12-01 04:00:00,0,0,0,0,0,0,0,0,0
2018-12-01 05:00:00,0,0,0,0,0,0,0,11,11
2018-12-01 06:00:00,0,11,0,0,0,0,11,11,33
2018-12-01 07:00:00,0,0,0,0,0,0,23,11,34
2018-12-01 08:00:00,0,11,0,59,0,0,35,0,105
2018-12-01 09:00:00,0,23,11,59,0,11,47,11,162
2018-12-01 10:00:00,0,82,0,47,23,11,236,0,399
2018-12-01 11:00:00,0,212,11,212,35,118,542,11,1141
2018-12-01 12:00:00,0,212,11,519,70,188,1097,47,2144
2018-12-01 13:00:00,0,377,0,495,153,271,1227,23,2546
2018-12-01 14:00:00,0,424,0,389,141,200,1604,11,2769
2018-12-01 15:00:00,0,401,11,306,47,247,1073,23,2108
2018-12-01 16:00:00,0,82,11,23,59,247,342,11,775
2018-12-01 17:00:00,0,23,0,35,23,94,200,23,398
2018-12-01 18:00:00,0,23,11,35,35,23,153,23,303
2018-12-01 19:00:00,0,47,0,35,11,0,94,11,198
2018-12-01 20:00:00,0,59,35,0,23,35,82,11,245
2018-12-01 21:00:00,0,11,0,0,0,0,59,0,70
2018-12-01 22:00:00,0,0,23,0,0,0,47,0,70
2018-12-01 23:00:00,0,0,11,0,0,11,35,0,57
2018-12-02 00:00:00,0,0,59,11,0,0,35,11,116
2018-12-02 01:00:00,0,0,0,0,0,0,35,0,35
2018-12-02 02:00:00,0,0,11,0,0,0,0,0,11
2018-12-02 03:00:00,0,0,0,0,11,0,35,59,105
2018-12-02 04:00:00,0,0,0,0,0,0,0,0,0
2018-12-02 05:00:00,0,0,0,0,0,0,0,11,11
2018-12-02 06:00:00,0,0,0,0,0,0,11,0,11
2018-12-02 07:00:00,0,0,0,0,0,0,11,0,11
2018-12-02 08:00:00,0,11,0,0,0,0,35,0,46
2018-12-02 09:00:00,0,35,0,11,0,0,11,0,57
2018-12-02 10:00:00,0,23,0,70,11,35,35,23,197
2018-12-02 11:00:00,0,59,11,70,35,94,247,23,539
2018-12-02 12:00:00,0,188,0,141,35,11,507,11,893
2018-12-02 13:00:00,0,247,0,259,82,106,790,23,1507
2018-12-02 14:00:00,0,141,0,200,59,141,814,35,1390
2018-12-02 15:00:00,0,271,11,507,106,35,967,35,1932
2018-12-02 16:00:00,0,306,11,672,94,35,590,35,1743
2018-12-02 17:00:00,0,47,11,106,11,11,118,0,304
2018-12-02 18:00:00,0,23,0,35,23,59,141,11,292
2018-12-02 19:00:00,0,35,0,0,11,23,47,0,116
2018-12-02 20:00:00,0,11,0,11,0,0,23,11,56
2018-12-02 21:00:00,0,0,0,0,23,23,0,0,46
2018-12-02 22:00:00,0,0,0,0,0,0,0,0,0
2018-12-02 23:00:00,0,0,0,0,0,0,11,0,11
2018-12-03 00:00:00,0,0,0,0,0,0,0,0,0
2018-12-03 01:00:00,0,0,0,0,0,0,0,11,11
2018-12-03 02:00:00,0,0,23,0,0,0,0,0,23
2018-12-03 03:00:00,0,0,0,0,0,0,0,0,0
2018-12-03 04:00:00,0,0,0,0,0,0,0,0,0
2018-12-03 05:00:00,0,0,0,0,0,0,0,23,23
2018-12-03 06:00:00,0,0,0,0,0,0,59,23,82
2018-12-03 07:00:00,0,11,11,23,0,23,11,11,90
2018-12-03 08:00:00,0,35,0,0,0,35,47,11,128
2018-12-03 09:00:00,0,35,0,0,0,11,59,0,105
2018-12-03 10:00:00,0,47,0,0,0,0,23,11,81
2018-12-03 11:00:00,0,11,11,11,0,0,82,23,138
2018-12-03 12:00:00,0,0,11,11,0,23,106,35,186
2018-12-03 13:00:00,0,23,23,23,11,23,118,35,256
2018-12-03 14:00:00,0,23,11,0,0,35,236,82,387
2018-12-03 15:00:00,0,0,23,0,0,70,82,23,198
2018-12-03 16:00:00,0,47,0,0,11,11,35,11,115
2018-12-03 17:00:00,0,11,0,0,0,0,35,0,46
2018-12-03 18:00:00,0,0,35,11,0,23,23,0,92
2018-12-03 19:00:00,0,11,0,0,0,0,11,0,22
2018-12-03 20:00:00,0,11,23,0,11,11,82,11,149
2018-12-03 21:00:00,0,0,0,0,0,23,47,0,70
2018-12-03 22:00:00,0,0,11,0,0,0,11,0,22
2018-12-03 23:00:00,0,23,0,0,0,0,23,0,46
2018-12-04 00:00:00,0,0,0,0,0,0,0,11,11
2018-12-04 01:00:00,0,0,0,0,0,0,11,0,11
2018-12-04 02:00:00,0,0,0,0,0,0,11,0,11
2018-12-04 03:00:00,0,0,0,0,0,0,0,0,0
2018-12-04 04:00:00,0,0,0,0,0,0,0,0,0
2018-12-04 05:00:00,0,0,0,0,0,0,0,11,11
2018-12-04 06:00:00,0,23,0,11,0,0,11,11,56
2018-12-04 07:00:00,0,23,0,11,11,0,11,0,56
2018-12-04 08:00:00,0,11,11,11,11,59,35,59,197
2018-12-04 09:00:00,0,23,0,0,23,11,82,23,162
2018-12-04 10:00:00,0,47,11,23,35,82,129,11,338
2018-12-04 11:00:00,0,47,23,35,70,106,165,11,457
2018-12-04 12:00:00,0,35,11,35,23,82,177,35,398
2018-12-04 13:00:00,0,94,11,0,35,82,200,35,457
2018-12-04 14:00:00,0,47,23,11,47,82,153,47,410
2018-12-04 15:00:00,0,35,23,23,0,59,118,11,269
2018-12-04 16:00:00,0,23,0,23,0,11,59,0,116
2018-12-04 17:00:00,0,23,23,11,11,11,94,47,220
2018-12-04 18:00:00,0,82,11,0,35,11,35,47,221
2018-12-04 19:00:00,0,11,11,0,0,0,70,23,115
2018-12-04 20:00:00,0,0,23,0,0,11,35,47,116
2018-12-04 21:00:00,0,0,23,11,0,11,0,0,45
2018-12-04 22:00:00,0,11,0,0,0,11,0,0,22
2018-12-04 23:00:00,0,35,11,0,0,0,11,23,80
2018-12-05 00:00:00,0,11,0,0,0,0,23,0,34
2018-12-05 01:00:00,0,11,0,0,0,0,0,0,11
2018-12-05 02:00:00,0,0,0,0,0,0,0,0,0
2018-12-05 03:00:00,0,0,0,0,0,0,11,0,11
2018-12-05 04:00:00,0,11,0,0,0,0,11,11,33
2018-12-05 05:00:00,0,0,0,0,0,0,0,11,11
2018-12-05 06:00:00,0,11,0,0,0,11,23,11,56
2018-12-05 07:00:00,0,35,0,11,0,23,47,47,163
2018-12-05 08:00:00,0,11,23,0,0,59,47,47,187
2018-12-05 09:00:00,0,23,23,0,0,23,0,23,92
2018-12-05 10:00:00,0,47,11,0,23,70,23,11,185
2018-12-05 11:00:00,0,59,0,11,0,35,212,23,340
2018-12-05 12:00:00,0,47,0,59,23,35,188,70,422
2018-12-05 13:00:00,0,94,23,59,0,82,118,35,411
2018-12-05 14:00:00,0,82,35,70,11,129,153,35,515
2018-12-05 15:00:00,0,82,23,0,11,70,106,47,339
2018-12-05 16:00:00,0,0,0,0,47,35,59,11,152
2018-12-05 17:00:00,0,35,0,35,0,106,94,11,281
2018-12-05 18:00:00,0,23,11,23,11,23,59,23,173
2018-12-05 19:00:00,0,0,11,23,0,0,47,11,92
2018-12-05 20:00:00,0,23,0,11,11,0,11,0,56
2018-12-05 21:00:00,0,11,0,0,0,0,35,0,46
2018-12-05 22:00:00,0,0,0,0,0,0,0,0,0
2018-12-05 23:00:00,0,0,0,0,0,0,0,0,0
2018-12-06 00:00:00,0,0,0,0,0,0,0,0,0
2018-12-06 01:00:00,0,0,0,0,0,0,0,0,0
2018-12-06 02:00:00,0,0,0,0,0,0,11,0,11
2018-12-06 03:00:00,0,11,0,0,0,0,0,0,11
2018-12-06 04:00:00,0,11,0,0,0,0,0,23,34
2018-12-06 05:00:00,0,11,0,0,0,0,11,23,45
2018-12-06 06:00:00,0,35,0,0,0,0,11,23,69
2018-12-06 07:00:00,0,23,11,0,0,0,47,59,140
2018-12-06 08:00:00,0,23,11,11,0,23,47,70,185
2018-12-06 09:00:00,0,59,47,0,11,0,47,23,187
2018-12-06 10:00:00,0,70,23,23,11,23,70,11,231
2018-12-06 11:00:00,0,82,0,0,11,11,129,11,244
2018-12-06 12:00:00,0,82,59,23,23,35,177,0,399
2018-12-06 13:00:00,0,165,0,59,35,11,94,11,375
2018-12-06 14:00:00,0,59,35,0,11,23,118,35,281
2018-12-06 15:00:00,0,35,47,35,23,0,129,35,304
2018-12-06 16:00:00,0,11,11,11,23,0,47,23,126
2018-12-06 17:00:00,0,47,0,0,11,0,70,0,128
2018-12-06 18:00:00,0,11,23,23,0,0,23,0,80
2018-12-06 19:00:00,0,82,0,0,0,0,0,11,93
2018-12-06 20:00:00,0,0,0,23,0,0,0,0,23
2018-12-06 21:00:00,0,23,23,23,0,0,0,0,69
2018-12-06 22:00:00,0,11,0,0,0,0,23,0,34
2018-12-06 23:00:00,0,0,0,0,0,0,0,0,0
2018-12-07 00:00:00,0,0,0,0,0,0,0,0,0
2018-12-07 01:00:00,0,0,0,0,0,0,11,0,11
2018-12-07 02:00:00,0,0,0,0,0,0,0,0,0
2018-12-07 03:00:00,0,0,0,0,0,0,23,11,34
2018-12-07 04:00:00,0,0,0,0,0,0,11,0,11
2018-12-07 05:00:00,0,0,0,0,0,0,0,0,0
2018-12-07 06:00:00,0,0,0,0,0,11,0,0,11
2018-12-07 07:00:00,0,0,0,0,0,47,0,11,58
2018-12-07 08:00:00,0,0,0,0,0,23,0,35,58
2018-12-07 09:00:00,0,0,0,0,0,11,0,0,11
2018-12-07 10:00:00,0,0,0,23,0,35,0,11,69
2018-12-07 11:00:00,0,0,0,11,0,35,0,11,57
2018-12-07 12:00:00,0,0,0,11,0,23,0,23,57
2018-12-07 13:00:00,0,0,0,11,0,0,0,11,22
2018-12-07 14:00:00,0,0,0,11,0,59,0,0,70
2018-12-07 15:00:00,0,0,0,11,0,47,0,59,117
2018-12-07 16:00:00,0,0,0,0,0,47,0,0,47
2018-12-07 17:00:00,0,0,0,11,0,0,0,11,22
2018-12-07 18:00:00,0,0,0,35,0,11,0,23,69
2018-12-07 19:00:00,0,0,0,11,0,23,0,11,45
2018-12-07 20:00:00,0,0,0,0,0,11,0,0,11
2018-12-07 21:00:00,0,0,0,0,0,0,0,0,0
2018-12-07 22:00:00,0,0,0,11,0,0,0,0,11
2018-12-07 23:00:00,0,0,0,0,0,11,0,0,11
2018-12-08 00:00:00,0,0,11,0,11,35,11,0,68
2018-12-08 01:00:00,0,23,0,11,0,35,35,0,104
2018-12-08 02:00:00,0,0,11,0,0,0,0,0,11
2018-12-08 03:00:00,0,0,0,0,0,11,0,0,11
2018-12-08 04:00:00,0,0,0,0,0,0,23,0,23
2018-12-08 05:00:00,0,0,11,0,0,0,0,0,11
2018-12-08 06:00:00,0,0,0,0,0,0,11,0,11
2018-12-08 07:00:00,0,0,0,11,0,0,23,0,34
2018-12-08 08:00:00,0,23,35,35,11,11,94,0,209
2018-12-08 09:00:00,0,35,11,70,11,59,118,11,315
2018-12-08 10:00:00,0,106,11,212,82,59,212,70,752
2018-12-08 11:00:00,0,448,11,483,118,94,601,35,1790
2018-12-08 12:00:00,0,401,47,708,200,283,979,0,2618
2018-12-08 13:00:00,0,271,59,566,47,200,1097,35,2275
2018-12-08 14:00:00,0,236,23,436,118,141,885,23,1862
2018-12-08 15:00:00,0,106,106,141,70,283,354,23,1083
2018-12-08 16:00:00,0,35,23,59,47,35,365,11,575
2018-12-08 17:00:00,0,70,59,94,0,106,212,0,541
2018-12-08 18:00:00,0,23,59,23,23,11,177,11,327
2018-12-08 19:00:00,0,23,0,0,0,11,23,11,68
2018-12-08 20:00:00,0,35,0,0,0,0,94,0,129
2018-12-08 21:00:00,0,11,0,23,0,0,35,0,69
2018-12-08 22:00:00,0,0,0,0,0,0,106,0,106
2018-12-08 23:00:00,0,11,23,11,0,0,118,0,163
2018-12-09 00:00:00,0,0,35,70,23,0,59,11,198
2018-12-09 01:00:00,0,0,0,11,0,0,106,0,117
2018-12-09 02:00:00,0,0,23,0,0,0,23,0,46
2018-12-09 03:00:00,0,11,0,0,0,0,0,0,11
2018-12-09 04:00:00,0,0,0,0,0,0,35,0,35
2018-12-09 05:00:00,0,0,0,0,0,0,23,0,23
2018-12-09 06:00:00,0,0,0,0,0,0,35,0,35
2018-12-09 07:00:00,0,0,0,11,0,0,47,0,58
2018-12-09 08:00:00,0,0,11,0,0,0,35,0,46
2018-12-09 09:00:00,0,11,11,11,0,0,94,11,138
2018-12-09 10:00:00,0,94,0,106,0,82,141,35,458
2018-12-09 11:00:00,0,82,11,271,0,23,212,23,622
2018-12-09 12:00:00,0,377,165,837,47,141,790,59,2416
2018-12-09 13:00:00,0,472,23,908,118,177,1109,82,2889
2018-12-09 14:00:00,0,330,11,1085,47,283,1345,47,3148
2018-12-09 15:00:00,0,153,0,424,11,153,778,23,1542
2018-12-09 16:00:00,0,94,11,70,35,23,188,23,444
2018-12-09 17:00:00,0,0,11,47,11,47,47,0,163
2018-12-09 18:00:00,0,23,11,11,0,11,70,0,126
2018-12-09 19:00:00,0,11,0,0,11,11,70,47,150
2018-12-09 20:00:00,0,23,11,0,0,0,11,59,104
2018-12-09 21:00:00,0,11,0,11,0,11,47,11,91
2018-12-09 22:00:00,0,0,0,0,0,0,0,0,0
2018-12-09 23:00:00,0,0,11,0,0,0,23,11,45
2018-12-10 00:00:00,0,0,0,0,0,0,11,0,11
2018-12-10 01:00:00,0,0,0,0,0,0,0,0,0
2018-12-10 02:00:00,0,0,0,0,0,0,0,0,0
2018-12-10 03:00:00,0,0,0,0,0,0,0,0,0
2018-12-10 04:00:00,0,0,0,0,0,0,0,0,0
2018-12-10 05:00:00,0,0,0,0,0,0,11,0,11
2018-12-10 06:00:00,0,23,0,0,0,11,23,11,68
2018-12-10 07:00:00,0,0,0,35,0,11,23,0,69
2018-12-10 08:00:00,0,23,11,0,0,35,47,70,186
2018-12-10 09:00:00,0,23,0,0,0,23,70,11,127
2018-12-10 10:00:00,0,0,11,0,11,23,35,0,80
2018-12-10 11:00:00,0,11,0,0,0,23,94,23,151
2018-12-10 12:00:00,0,23,11,23,0,82,141,35,315
2018-12-10 13:00:00,0,35,23,0,11,23,94,23,209
2018-12-10 14:00:00,0,35,0,0,0,70,129,35,269
2018-12-10 15:00:00,0,23,11,35,0,35,70,35,209
2018-12-10 16:00:00,0,59,11,11,11,0,70,35,197
2018-12-10 17:00:00,0,23,0,11,23,11,35,0,103
2018-12-10 18:00:00,0,11,0,0,11,23,11,0,56
2018-12-10 19:00:00,0,23,0,11,0,23,35,0,92
2018-12-10 20:00:00,0,23,11,0,0,0,11,11,56
2018-12-10 21:00:00,0,11,0,0,0,23,23,0,57
2018-12-10 22:00:00,0,0,0,0,0,0,0,0,0
2018-12-10 23:00:00,0,0,0,0,0,0,0,0,0
2018-12-11 00:00:00,0,0,0,0,0,0,0,0,0
2018-12-11 01:00:00,0,0,0,0,0,0,0,0,0
2018-12-11 02:00:00,0,0,0,0,0,0,0,0,0
2018-12-11 03:00:00,0,0,0,0,0,0,0,0,0
2018-12-11 04:00:00,0,0,0,0,0,0,0,0,0
2018-12-11 05:00:00,0,0,0,0,0,0,0,0,0
2018-12-11 06:00:00,0,0,0,0,0,0,35,11,46
2018-12-11 07:00:00,0,0,11,11,0,11,47,0,80
2018-12-11 08:00:00,0,11,23,0,0,11,11,47,103
2018-12-11 09:00:00,0,11,0,0,47,0,35,0,93
2018-12-11 10:00:00,0,70,11,0,23,11,70,11,196
2018-12-11 11:00:00,0,82,0,0,0,47,94,47,270
2018-12-11 12:00:00,0,82,0,35,11,35,177,35,375
2018-12-11 13:00:00,0,82,23,59,47,11,153,11,386
2018-12-11 14:00:00,0,59,23,35,11,59,153,47,387
2018-12-11 15:00:00,0,35,35,0,0,11,82,23,186
2018-12-11 16:00:00,0,35,11,11,47,23,165,35,327
2018-12-11 17:00:00,0,11,0,35,0,0,59,23,128
2018-12-11 18:00:00,0,11,23,0,23,35,70,35,197
2018-12-11 19:00:00,0,23,0,0,11,11,11,0,56
2018-12-11 20:00:00,0,11,11,0,0,0,11,11,44
2018-12-11 21:00:00,0,23,0,0,23,35,47,0,128
2018-12-11 22:00:00,0,0,0,0,0,0,11,0,11
2018-12-11 23:00:00,0,11,0,0,0,11,11,11,44
2018-12-12 00:00:00,0,11,0,0,0,0,11,0,22
2018-12-12 01:00:00,0,11,0,0,0,0,0,0,11
2018-12-12 02:00:00,0,23,0,0,0,0,0,0,23
2018-12-12 03:00:00,0,23,0,0,0,0,11,0,34
2018-12-12 04:00:00,0,23,0,0,0,0,11,0,34
2018-12-12 05:00:00,0,11,0,0,0,0,0,11,22
2018-12-12 06:00:00,0,23,0,0,0,23,35,0,81
2018-12-12 07:00:00,0,11,0,11,0,0,35,47,104
2018-12-12 08:00:00,0,11,0,47,0,0,35,35,128
2018-12-12 09:00:00,0,0,0,0,11,0,47,0,58
2018-12-12 10:00:00,0,0,0,0,11,0,35,0,46
2018-12-12 11:00:00,0,0,0,11,35,0,165,0,211
2018-12-12 12:00:00,0,0,0,35,0,0,188,0,223
2018-12-12 13:00:00,0,0,0,35,11,0,330,0,376
2018-12-12 14:00:00,0,0,0,23,0,0,35,0,58
2018-12-12 15:00:00,0,0,0,35,82,0,35,0,152
2018-12-12 16:00:00,0,0,0,11,23,0,70,0,104
2018-12-12 17:00:00,0,0,0,0,0,0,82,0,82
2018-12-12 18:00:00,0,0,0,11,11,0,35,0,57
2018-12-12 19:00:00,0,0,0,11,0,0,0,0,11
2018-12-12 20:00:00,0,0,0,0,0,0,0,0,0
2018-12-12 21:00:00,0,0,0,0,0,0,11,0,11
2018-12-12 22:00:00,0,0,0,0,0,0,0,0,0
2018-12-12 23:00:00,0,0,0,0,0,0,11,0,11
2018-12-13 00:00:00,0,0,0,0,0,0,11,11,22
2018-12-13 01:00:00,0,0,0,0,0,0,0,0,0
2018-12-13 02:00:00,0,0,0,0,0,0,0,0,0
2018-12-13 03:00:00,0,0,0,0,0,0,0,0,0
2018-12-13 04:00:00,0,0,0,0,0,0,0,0,0
2018-12-13 05:00:00,0,0,0,0,0,0,11,0,11
2018-12-13 06:00:00,0,11,0,0,0,0,35,11,57
2018-12-13 07:00:00,0,23,0,11,0,0,35,11,80
2018-12-13 08:00:00,0,0,47,0,11,0,0,35,93
2018-12-13 09:00:00,0,11,35,0,0,0,47,0,93
2018-12-13 10:00:00,0,94,35,11,0,0,106,23,269
2018-12-13 11:00:00,0,70,35,47,0,23,141,0,316
2018-12-13 12:00:00,0,70,0,11,11,0,82,35,209
2018-12-13 13:00:00,0,47,11,23,23,11,188,23,326
2018-12-13 14:00:00,0,47,11,0,0,23,165,11,257
2018-12-13 15:00:00,0,47,23,0,0,0,23,11,104
2018-12-13 16:00:00,0,0,0,0,0,0,0,0,0
2018-12-13 17:00:00,0,0,0,0,0,0,0,0,0
2018-12-13 18:00:00,0,0,0,0,0,0,0,0,0
2018-12-13 19:00:00,0,0,0,0,0,0,0,0,0
2018-12-13 20:00:00,0,11,0,0,0,0,11,0,22
2018-12-13 21:00:00,0,0,0,0,0,0,0,0,0
2018-12-13 22:00:00,0,0,0,0,0,0,0,0,0
2018-12-13 23:00:00,0,0,0,0,0,0,0,0,0
2018-12-14 00:00:00,0,0,0,0,0,11,23,0,34
2018-12-14 01:00:00,0,0,0,0,0,23,11,0,34
2018-12-14 02:00:00,0,11,0,0,0,0,0,0,11
2018-12-14 03:00:00,0,0,11,0,0,0,0,0,11
2018-12-14 04:00:00,0,0,0,0,0,0,0,0,0
2018-12-14 05:00:00,0,11,0,0,0,0,11,0,22
2018-12-14 06:00:00,0,11,0,0,0,0,11,0,22
2018-12-14 07:00:00,0,35,0,0,23,0,70,11,139
2018-12-14 08:00:00,0,47,23,23,0,0,23,59,175
2018-12-14 09:00:00,0,11,0,11,11,0,23,0,56
2018-12-14 10:00:00,0,23,11,11,11,0,82,0,138
2018-12-14 11:00:00,0,47,11,0,11,70,118,35,292
2018-12-14 12:00:00,0,47,11,0,11,59,118,35,281
2018-12-14 13:00:00,0,47,11,0,0,23,177,59,317
2018-12-14 14:00:00,0,23,11,0,11,35,94,47,221
2018-12-14 15:00:00,0,23,0,0,11,47,70,0,151
2018-12-14 16:00:00,0,35,11,11,11,23,23,11,125
2018-12-14 17:00:00,0,23,35,0,11,23,94,11,197
2018-12-14 18:00:00,0,23,11,0,35,47,118,0,234
2018-12-14 19:00:00,0,23,0,47,70,11,35,35,221
2018-12-14 20:00:00,0,11,0,0,82,0,23,11,127
2018-12-14 21:00:00,0,23,0,0,47,0,11,0,81
2018-12-14 22:00:00,0,82,35,11,23,23,106,0,280
2018-12-14 23:00:00,0,0,23,0,47,35,94,0,199
2018-12-15 00:00:00,0,0,0,11,0,11,23,23,68
2018-12-15 01:00:00,0,0,23,0,11,0,23,35,92
2018-12-15 02:00:00,0,0,0,11,0,11,0,0,22
2018-12-15 03:00:00,0,0,0,11,0,0,0,11,22
2018-12-15 04:00:00,0,0,0,0,0,0,0,0,0
2018-12-15 05:00:00,0,0,0,0,0,0,0,0,0
2018-12-15 06:00:00,0,0,0,0,0,0,0,0,0
2018-12-15 07:00:00,0,0,0,0,0,0,0,0,0
2018-12-15 08:00:00,0,11,0,35,0,0,35,0,81
2018-12-15 09:00:00,0,11,0,94,11,0,106,23,245
2018-12-15 10:00:00,0,70,0,188,0,11,165,0,434
2018-12-15 11:00:00,0,188,0,342,23,82,318,11,964
2018-12-15 12:00:00,0,236,11,554,35,365,885,11,2097
2018-12-15 13:00:00,0,259,11,460,23,165,1050,70,2038
2018-12-15 14:00:00,0,271,0,271,23,271,660,47,1543
2018-12-15 15:00:00,0,165,0,212,94,141,578,11,1201
2018-12-15 16:00:00,0,59,0,82,23,35,271,11,481
2018-12-15 17:00:00,0,11,11,0,0,23,165,23,233
2018-12-15 18:00:00,0,11,0,11,0,0,59,23,104
2018-12-15 19:00:00,0,0,0,11,0,11,47,0,69
2018-12-15 20:00:00,0,23,0,0,0,11,11,11,56
2018-12-15 21:00:00,0,0,0,0,0,0,11,0,11
2018-12-15 22:00:00,0,0,0,0,0,0,47,0,47
2018-12-15 23:00:00,0,0,0,0,0,0,11,0,11
2018-12-16 00:00:00,0,0,0,0,0,0,47,0,47
2018-12-16 01:00:00,0,11,11,0,0,0,82,0,104
2018-12-16 02:00:00,0,0,0,0,0,0,23,11,34
2018-12-16 03:00:00,0,0,0,0,0,0,0,11,11
2018-12-16 04:00:00,0,0,0,0,0,0,47,0,47
2018-12-16 05:00:00,0,0,0,0,0,0,23,0,23
2018-12-16 06:00:00,0,11,0,0,0,0,0,0,11
2018-12-16 07:00:00,0,11,0,0,0,0,11,0,22
2018-12-16 08:00:00,0,11,0,0,0,11,11,0,33
2018-12-16 09:00:00,0,11,0,35,0,11,35,23,115
2018-12-16 10:00:00,0,11,23,118,0,11,35,11,209
2018-12-16 11:00:00,0,94,0,165,11,47,295,11,623
2018-12-16 12:00:00,0,295,0,507,11,165,590,11,1579
2018-12-16 13:00:00,0,377,0,531,106,188,719,23,1944
2018-12-16 14:00:00,0,153,0,389,59,236,519,59,1415
2018-12-16 15:00:00,0,106,0,247,35,70,377,23,858
2018-12-16 16:00:00,0,70,35,141,11,23,236,11,527
2018-12-16 17:00:00,0,59,23,59,23,59,118,0,341
2018-12-16 18:00:00,0,0,23,0,11,11,47,0,92
2018-12-16 19:00:00,0,118,47,23,35,35,11,0,269
2018-12-16 20:00:00,0,0,0,0,11,11,11,0,33
2018-12-16 21:00:00,0,0,11,0,11,0,0,11,33
2018-12-16 22:00:00,0,0,0,0,11,0,0,0,11
2018-12-16 23:00:00,0,0,0,0,11,0,0,0,11
2018-12-17 00:00:00,0,0,0,11,11,0,0,0,22
2018-12-17 01:00:00,0,0,0,0,0,0,0,0,0
2018-12-17 02:00:00,0,0,0,0,0,0,0,0,0
2018-12-17 03:00:00,0,0,0,0,11,0,0,0,11
2018-12-17 04:00:00,0,0,0,0,0,0,0,0,0
2018-12-17 05:00:00,0,0,0,0,0,0,11,0,11
2018-12-17 06:00:00,0,0,0,0,0,11,11,35,57
2018-12-17 07:00:00,0,11,0,0,0,0,35,35,81
2018-12-17 08:00:00,0,23,0,0,0,23,0,47,93
2018-12-17 09:00:00,0,35,0,0,11,0,0,23,69
2018-12-17 10:00:00,0,94,0,23,0,0,118,35,270
2018-12-17 11:00:00,0,70,11,11,11,11,59,94,267
2018-12-17 12:00:00,0,35,59,70,0,59,165,35,423
2018-12-17 13:00:00,0,70,0,35,11,47,106,106,375
2018-12-17 14:00:00,0,59,11,11,23,35,59,59,257
2018-12-17 15:00:00,0,47,11,47,0,35,141,23,304
2018-12-17 16:00:00,0,23,0,11,0,47,106,35,222
2018-12-17 17:00:00,0,0,11,23,23,23,70,11,161
2018-12-17 18:00:00,0,35,0,35,0,23,70,23,186
2018-12-17 19:00:00,0,11,0,11,0,0,47,0,69
2018-12-17 20:00:00,0,106,11,11,0,0,47,0,175
2018-12-17 21:00:00,0,0,0,11,0,11,70,11,103
2018-12-17 22:00:00,0,11,0,0,0,0,23,0,34
2018-12-17 23:00:00,0,0,0,0,0,0,0,11,11
2018-12-18 00:00:00,0,0,0,0,0,0,0,0,0
2018-12-18 01:00:00,0,0,0,0,0,0,0,0,0
2018-12-18 02:00:00,0,0,0,0,0,0,0,0,0
2018-12-18 03:00:00,0,0,0,0,0,0,0,0,0
2018-12-18 04:00:00,0,0,0,0,0,0,0,0,0
2018-12-18 05:00:00,0,0,0,0,11,0,23,0,34
2018-12-18 06:00:00,0,0,0,0,0,0,35,0,35
2018-12-18 07:00:00,0,0,0,11,0,11,11,0,33
2018-12-18 08:00:00,0,23,0,0,0,0,94,106,223
2018-12-18 09:00:00,0,47,0,11,0,11,47,0,116
2018-12-18 10:00:00,0,11,11,47,47,23,188,35,362
2018-12-18 11:00:00,0,35,11,106,0,82,224,23,481
2018-12-18 12:00:00,0,59,0,35,35,82,271,35,517
2018-12-18 13:00:00,0,129,0,59,23,59,306,47,623
2018-12-18 14:00:00,0,35,11,23,11,23,129,35,267
2018-12-18 15:00:00,0,35,0,47,11,47,82,23,245
2018-12-18 16:00:00,0,35,0,23,0,82,23,0,163
2018-12-18 17:00:00,0,11,0,35,0,35,35,0,116
2018-12-18 18:00:00,0,23,0,11,0,11,35,11,91
2018-12-18 19:00:00,0,23,11,11,0,11,35,0,91
2018-12-18 20:00:00,0,11,0,11,11,0,11,0,44
2018-12-18 21:00:00,0,0,0,0,11,0,35,0,46
2018-12-18 22:00:00,0,0,0,0,0,0,35,0,35
2018-12-18 23:00:00,0,0,0,0,0,11,0,0,11
2018-12-19 00:00:00,0,0,0,0,0,0,0,0,0
2018-12-19 01:00:00,0,11,0,0,0,0,11,0,22
2018-12-19 02:00:00,0,0,0,0,0,0,0,0,0
2018-12-19 03:00:00,0,0,0,11,0,0,0,0,11
2018-12-19 04:00:00,0,0,0,0,0,0,0,0,0
2018-12-19 05:00:00,0,0,0,0,0,0,11,11,22
2018-12-19 06:00:00,0,0,0,11,0,0,11,11,33
2018-12-19 07:00:00,0,0,11,11,0,11,35,11,79
2018-12-19 08:00:00,0,11,0,0,11,0,47,47,116
2018-12-19 09:00:00,0,23,11,0,35,59,35,35,198
2018-12-19 10:00:00,0,70,11,0,35,35,35,23,209
2018-12-19 11:00:00,0,59,0,23,23,94,118,23,340
2018-12-19 12:00:00,0,94,11,0,11,23,165,94,398
2018-12-19 13:00:00,0,59,0,0,23,47,330,47,506
2018-12-19 14:00:00,0,94,0,23,0,47,177,59,400
2018-12-19 15:00:00,0,47,0,23,47,23,106,23,269
2018-12-19 16:00:00,0,11,0,23,11,47,82,23,197
2018-12-19 17:00:00,0,11,0,0,0,0,70,0,81
2018-12-19 18:00:00,0,23,0,0,0,0,11,11,45
2018-12-19 19:00:00,0,11,0,0,0,0,11,0,22
2018-12-19 20:00:00,0,11,0,0,0,0,11,0,22
2018-12-19 21:00:00,0,0,0,0,0,0,0,0,0
2018-12-19 22:00:00,0,0,0,0,0,0,0,0,0
2018-12-19 23:00:00,0,0,0,0,0,0,0,0,0
2018-12-20 00:00:00,11,23,0,0,0,11,0,0,45
2018-12-20 01:00:00,0,0,0,0,0,0,0,0,0
2018-12-20 02:00:00,0,0,0,0,0,0,0,0,0
2018-12-20 03:00:00,0,0,0,11,0,0,0,0,11
2018-12-20 04:00:00,0,0,0,11,0,0,0,0,11
2018-12-20 05:00:00,0,0,0,11,0,0,0,0,11
2018-12-20 06:00:00,0,23,0,11,0,11,11,11,67
2018-12-20 07:00:00,0,23,0,59,11,0,35,23,151
2018-12-20 08:00:00,0,59,0,23,35,0,23,59,199
2018-12-20 09:00:00,0,23,0,23,35,11,23,11,126
2018-12-20 10:00:00,35,47,0,23,59,23,47,23,257
2018-12-20 11:00:00,82,47,11,23,23,11,118,23,338
2018-12-20 12:00:00,59,23,35,59,35,23,200,23,457
2018-12-20 13:00:00,11,94,0,0,11,11,106,35,268
2018-12-20 14:00:00,129,47,11,0,11,11,141,35,385
2018-12-20 15:00:00,165,47,0,35,0,35,118,35,435
2018-12-20 16:00:00,23,23,0,35,23,11,59,11,185
2018-12-20 17:00:00,47,23,0,59,59,11,70,11,280
2018-12-20 18:00:00,23,0,0,11,0,47,23,11,115
2018-12-20 19:00:00,59,47,0,47,11,23,23,0,210
2018-12-20 20:00:00,70,47,0,11,11,59,11,0,209
2018-12-20 21:00:00,0,11,0,0,0,23,11,0,45
2018-12-20 22:00:00,11,0,0,0,11,11,0,0,33
2018-12-20 23:00:00,0,0,0,0,0,0,0,0,0
2018-12-21 00:00:00,0,0,0,0,0,0,0,0,0
2018-12-21 01:00:00,0,0,0,0,0,0,11,0,11
2018-12-21 02:00:00,0,0,0,0,0,0,0,0,0
2018-12-21 03:00:00,0,0,0,0,0,0,0,0,0
2018-12-21 04:00:00,11,0,0,0,0,0,0,11,22
2018-12-21 05:00:00,23,0,0,0,0,0,0,0,23
2018-12-21 06:00:00,35,0,0,11,11,0,0,23,80
2018-12-21 07:00:00,47,11,0,0,0,0,47,11,116
2018-12-21 08:00:00,47,35,0,23,11,0,23,59,198
2018-12-21 09:00:00,0,35,0,0,0,0,11,0,46
2018-12-21 10:00:00,106,47,11,11,0,35,59,23,292
2018-12-21 11:00:00,129,35,11,11,11,35,177,35,444
2018-12-21 12:00:00,59,59,0,0,23,23,118,70,352
2018-12-21 13:00:00,23,70,0,11,35,23,188,11,361
2018-12-21 14:00:00,70,59,11,35,35,35,94,11,350
2018-12-21 15:00:00,23,11,0,0,0,0,70,11,115
2018-12-21 16:00:00,47,11,0,11,0,23,141,11,244
2018-12-21 17:00:00,59,59,0,47,35,11,23,0,234
2018-12-21 18:00:00,59,11,0,35,0,11,23,23,162
2018-12-21 19:00:00,224,94,0,23,0,35,118,0,494
2018-12-21 20:00:00,82,0,0,11,0,11,82,11,197
2018-12-21 21:00:00,23,11,0,11,0,0,11,0,56
2018-12-21 22:00:00,47,11,0,11,0,82,11,0,162
2018-12-21 23:00:00,11,23,0,0,11,0,35,0,80
2018-12-22 00:00:00,11,0,0,0,0,0,0,0,11
2018-12-22 01:00:00,23,0,0,0,0,23,0,0,46
2018-12-22 02:00:00,11,11,0,0,0,0,59,0,81
2018-12-22 03:00:00,0,0,0,0,0,0,0,0,0
2018-12-22 04:00:00,0,0,0,0,0,0,0,0,0
2018-12-22 05:00:00,0,0,0,0,0,0,0,0,0
2018-12-22 06:00:00,0,0,0,0,0,0,0,0,0
2018-12-22 07:00:00,0,0,0,11,11,0,0,0,22
2018-12-22 08:00:00,11,11,0,0,0,11,23,0,56
2018-12-22 09:00:00,23,0,0,0,0,0,23,11,57
2018-12-22 10:00:00,23,23,11,23,0,35,35,47,197
2018-12-22 11:00:00,141,35,11,94,23,129,118,11,562
2018-12-22 12:00:00,118,165,11,118,0,35,11,35,493
2018-12-22 13:00:00,129,70,11,47,11,129,0,35,432
2018-12-22 14:00:00,153,141,11,118,35,118,0,11,587
2018-12-22 15:00:00,23,94,0,35,35,47,0,11,245
2018-12-22 16:00:00,47,47,0,35,11,35,0,0,175
2018-12-22 17:00:00,23,0,0,11,11,11,0,23,79
2018-12-22 18:00:00,0,35,0,11,23,23,0,0,92
2018-12-22 19:00:00,23,23,0,11,0,11,0,0,68
2018-12-22 20:00:00,0,0,0,0,0,23,0,0,23
2018-12-22 21:00:00,0,0,11,0,0,0,0,23,34
2018-12-22 22:00:00,23,11,0,11,0,0,0,0,45
2018-12-22 23:00:00,0,0,0,0,0,0,0,0,0
2018-12-23 00:00:00,11,0,0,0,0,0,23,0,34
2018-12-23 01:00:00,0,0,0,23,0,11,11,0,45
2018-12-23 02:00:00,0,0,0,0,0,0,35,0,35
2018-12-23 03:00:00,0,0,0,0,0,0,35,0,35
2018-12-23 04:00:00,0,0,0,0,0,0,59,0,59
2018-12-23 05:00:00,0,0,11,0,0,0,59,0,70
2018-12-23 06:00:00,0,0,0,0,0,0,23,0,23
2018-12-23 07:00:00,0,0,0,0,0,0,35,11,46
2018-12-23 08:00:00,0,0,0,0,0,0,47,0,47
2018-12-23 09:00:00,106,11,0,0,35,0,11,35,198
2018-12-23 10:00:00,35,47,23,0,0,0,35,23,163
2018-12-23 11:00:00,70,11,0,0,11,23,106,0,221
2018-12-23 12:00:00,23,47,11,106,23,47,283,70,610
2018-12-23 13:00:00,106,118,0,82,47,106,236,23,718
2018-12-23 14:00:00,224,259,0,82,0,106,448,23,1142
2018-12-23 15:00:00,106,70,0,47,47,59,259,11,599
2018-12-23 16:00:00,82,59,0,23,23,70,165,0,422
2018-12-23 17:00:00,47,11,0,0,23,11,23,0,115
2018-12-23 18:00:00,23,35,0,11,0,0,11,35,115
2018-12-23 19:00:00,11,0,0,0,0,0,23,35,69
2018-12-23 20:00:00,23,0,0,11,0,0,11,0,45
2018-12-23 21:00:00,0,0,0,0,0,0,0,0,0
2018-12-23 22:00:00,11,11,0,0,11,11,0,0,44
2018-12-23 23:00:00,0,0,0,0,0,0,11,0,11
2018-12-24 00:00:00,0,0,0,11,0,0,0,0,11
2018-12-24 01:00:00,0,0,0,0,0,0,0,0,0
2018-12-24 02:00:00,0,11,0,0,0,0,11,0,22
2018-12-24 03:00:00,0,0,0,0,0,0,0,0,0
2018-12-24 04:00:00,11,0,0,0,0,0,0,0,11
2018-12-24 05:00:00,0,0,0,0,0,0,0,0,0
2018-12-24 06:00:00,0,0,0,0,0,0,0,0,0
2018-12-24 07:00:00,0,0,0,0,0,0,0,0,0
2018-12-24 08:00:00,0,0,0,0,0,0,11,11,22
2018-12-24 09:00:00,23,11,0,11,0,0,0,11,56
2018-12-24 10:00:00,11,23,0,23,0,11,35,0,103
2018-12-24 11:00:00,0,70,11,11,0,0,23,0,115
2018-12-24 12:00:00,11,70,0,23,0,47,47,0,198
2018-12-24 13:00:00,47,70,0,23,0,59,94,0,293
2018-12-24 14:00:00,94,82,11,11,47,0,35,0,280
2018-12-24 15:00:00,23,35,11,35,11,11,35,0,161
2018-12-24 16:00:00,47,708,0,0,0,0,0,11,766
2018-12-24 17:00:00,11,0,0,23,0,0,35,0,69
2018-12-24 18:00:00,23,35,0,0,0,0,11,0,69
2018-12-24 19:00:00,23,11,0,0,0,0,0,0,34
2018-12-24 20:00:00,0,0,0,0,0,0,23,0,23
2018-12-24 21:00:00,11,0,0,11,0,0,0,0,22
2018-12-24 22:00:00,11,0,0,0,0,0,0,11,22
2018-12-24 23:00:00,0,11,0,0,0,0,11,11,33
2018-12-25 00:00:00,11,0,0,11,0,0,0,0,22
2018-12-25 01:00:00,11,0,0,0,0,0,0,0,11
2018-12-25 02:00:00,11,0,0,0,0,0,0,0,11
2018-12-25 03:00:00,0,11,0,0,0,0,11,0,22
2018-12-25 04:00:00,0,0,0,0,0,0,0,0,0
2018-12-25 05:00:00,0,0,0,0,0,0,0,0,0
2018-12-25 06:00:00,0,0,0,0,0,0,0,0,0
2018-12-25 07:00:00,0,0,0,0,0,0,0,0,0
2018-12-25 08:00:00,0,0,0,0,0,0,0,0,0
2018-12-25 09:00:00,23,0,0,0,0,0,0,0,23
2018-12-25 10:00:00,11,23,11,0,0,0,11,0,56
2018-12-25 11:00:00,11,0,11,0,11,23,0,23,79
2018-12-25 12:00:00,47,23,11,11,0,11,35,23,161
2018-12-25 13:00:00,82,118,11,47,0,47,59,35,399
2018-12-25 14:00:00,94,177,23,23,23,82,118,35,575
2018-12-25 15:00:00,165,47,129,23,23,106,118,11,622
2018-12-25 16:00:00,59,11,0,0,0,23,59,70,222
2018-12-25 17:00:00,94,23,0,0,11,23,35,11,197
2018-12-25 18:00:00,47,0,0,0,0,0,11,11,69
2018-12-25 19:00:00,35,11,0,0,11,23,11,0,91
2018-12-25 20:00:00,23,59,11,0,0,0,35,0,128
2018-12-25 21:00:00,23,0,35,0,0,11,47,0,116
2018-12-25 22:00:00,11,11,0,0,0,0,0,0,22
2018-12-25 23:00:00,0,0,0,0,0,0,11,0,11
2018-12-26 00:00:00,11,0,0,0,0,0,23,0,34
2018-12-26 01:00:00,11,0,0,0,0,0,11,35,57
2018-12-26 02:00:00,0,0,0,0,0,0,0,0,0
2018-12-26 03:00:00,11,0,0,0,0,0,0,0,11
2018-12-26 04:00:00,0,0,0,0,0,0,11,0,11
2018-12-26 05:00:00,0,0,0,0,0,0,0,0,0
2018-12-26 06:00:00,0,0,0,0,0,0,0,0,0
2018-12-26 07:00:00,0,0,0,0,11,0,0,0,11
2018-12-26 08:00:00,11,0,0,0,0,0,0,0,11
2018-12-26 09:00:00,11,0,11,0,0,0,0,0,22
2018-12-26 10:00:00,23,11,0,0,0,0,0,0,34
2018-12-26 11:00:00,23,23,11,35,0,23,11,23,149
2018-12-26 12:00:00,35,82,11,47,35,47,70,35,362
2018-12-26 13:00:00,212,82,0,118,35,118,177,23,765
2018-12-26 14:00:00,82,35,23,0,11,82,129,23,385
2018-12-26 15:00:00,129,59,0,35,0,59,47,0,329
2018-12-26 16:00:00,23,23,0,11,0,59,35,47,198
2018-12-26 17:00:00,0,0,0,0,11,59,11,0,81
2018-12-26 18:00:00,11,0,0,11,0,35,11,0,68
2018-12-26 19:00:00,23,0,11,11,11,0,0,0,56
2018-12-26 20:00:00,35,0,0,0,47,23,0,0,105
2018-12-26 21:00:00,0,11,0,0,0,0,11,0,22
2018-12-26 22:00:00,0,0,0,23,0,0,0,0,23
2018-12-26 23:00:00,23,0,0,23,0,0,11,11,68
2018-12-27 00:00:00,35,11,0,11,0,11,11,0,79
2018-12-27 01:00:00,23,11,0,11,0,0,23,0,68
2018-12-27 02:00:00,23,0,0,11,0,0,11,11,56
2018-12-27 03:00:00,0,0,0,11,0,0,0,0,11
2018-12-27 04:00:00,0,0,0,0,0,0,11,0,11
2018-12-27 05:00:00,0,0,0,0,0,0,0,0,0
2018-12-27 06:00:00,0,0,0,0,0,0,11,0,11
2018-12-27 07:00:00,0,0,0,0,0,0,0,0,0
2018-12-27 08:00:00,11,0,0,0,0,0,0,11,22
2018-12-27 09:00:00,11,0,0,0,0,0,11,23,45
2018-12-27 10:00:00,0,23,11,0,0,11,47,11,103
2018-12-27 11:00:00,11,23,0,11,0,0,82,11,138
2018-12-27 12:00:00,70,35,0,0,0,11,129,0,245
2018-12-27 13:00:00,47,70,0,35,11,23,129,11,326
2018-12-27 14:00:00,35,35,0,0,0,23,212,23,328
2018-12-27 15:00:00,35,35,0,11,11,35,118,11,256
2018-12-27 16:00:00,129,35,0,11,35,23,59,0,292
2018-12-27 17:00:00,59,0,0,11,0,0,0,11,81
2018-12-27 18:00:00,11,0,0,35,0,0,23,0,69
2018-12-27 19:00:00,23,0,0,0,0,11,59,0,93
2018-12-27 20:00:00,118,0,0,11,11,11,23,11,185
2018-12-27 21:00:00,23,0,0,11,0,0,23,0,57
2018-12-27 22:00:00,35,23,0,23,0,11,11,0,103
2018-12-27 23:00:00,11,0,0,11,0,0,35,0,57
2018-12-28 00:00:00,0,0,0,0,0,0,11,0,11
2018-12-28 01:00:00,0,0,0,0,0,0,0,0,0
2018-12-28 02:00:00,0,0,0,0,0,0,0,0,0
2018-12-28 03:00:00,0,0,0,0,0,0,0,0,0
2018-12-28 04:00:00,0,0,0,0,0,0,0,0,0
2018-12-28 05:00:00,11,0,0,0,0,0,0,0,11
2018-12-28 06:00:00,0,11,0,0,0,0,11,0,22
2018-12-28 07:00:00,23,0,0,0,0,0,0,11,34
2018-12-28 08:00:00,23,0,0,0,0,0,23,11,57
2018-12-28 09:00:00,11,0,0,0,0,23,0,23,57
2018-12-28 10:00:00,23,0,11,0,11,11,23,0,79
2018-12-28 11:00:00,47,153,0,11,23,0,118,23,375
2018-12-28 12:00:00,330,94,0,70,35,35,448,0,1012
2018-12-28 13:00:00,94,106,0,47,11,47,295,35,635
2018-12-28 14:00:00,82,236,23,23,11,59,212,11,657
2018-12-28 15:00:00,82,141,0,35,35,59,188,23,563
2018-12-28 16:00:00,70,35,0,11,11,23,94,23,267
2018-12-28 17:00:00,35,0,0,11,11,23,47,23,150
2018-12-28 18:00:00,59,0,0,0,0,0,0,23,82
2018-12-28 19:00:00,23,11,0,0,0,11,35,0,80
2018-12-28 20:00:00,11,0,0,0,0,0,11,0,22
2018-12-28 21:00:00,11,129,0,0,0,11,59,11,221
2018-12-28 22:00:00,0,94,0,0,0,11,35,0,140
2018-12-28 23:00:00,23,11,0,0,23,35,0,11,103
2018-12-29 00:00:00,23,0,0,11,0,23,11,23,91
2018-12-29 01:00:00,11,0,0,11,0,0,11,11,44
2018-12-29 02:00:00,0,0,0,11,0,11,11,23,56
2018-12-29 03:00:00,0,0,0,0,0,0,11,23,34
2018-12-29 04:00:00,0,0,0,0,0,0,11,0,11
2018-12-29 05:00:00,0,0,0,0,0,0,0,11,11
2018-12-29 06:00:00,0,0,0,0,0,0,11,11,22
2018-12-29 07:00:00,0,0,0,0,0,0,11,0,11
2018-12-29 08:00:00,11,0,0,0,0,0,23,0,34
2018-12-29 09:00:00,47,0,0,23,11,0,23,11,115
2018-12-29 10:00:00,35,11,11,11,11,0,141,11,231
2018-12-29 11:00:00,59,59,35,23,0,35,59,0,270
2018-12-29 12:00:00,47,106,0,59,0,23,106,11,352
2018-12-29 13:00:00,59,118,0,35,11,35,295,59,612
2018-12-29 14:00:00,283,94,0,82,47,118,259,11,894
2018-12-29 15:00:00,129,59,0,35,0,47,165,35,470
2018-12-29 16:00:00,106,47,0,0,11,94,94,0,352
2018-12-29 17:00:00,47,106,0,11,11,0,70,11,256
2018-12-29 18:00:00,11,23,0,35,11,35,35,0,150
2018-12-29 19:00:00,0,23,0,11,11,11,11,0,67
2018-12-29 20:00:00,0,47,0,11,0,0,0,0,58
2018-12-29 21:00:00,23,0,0,23,0,0,11,11,68
2018-12-29 22:00:00,11,11,0,0,0,11,0,0,33
2018-12-29 23:00:00,11,0,0,0,0,11,0,0,22
2018-12-30 00:00:00,23,11,0,0,0,0,0,0,34
2018-12-30 01:00:00,0,0,0,0,0,0,23,0,23
2018-12-30 02:00:00,0,0,0,0,0,0,11,0,11
2018-12-30 03:00:00,0,0,0,0,0,0,0,0,0
2018-12-30 04:00:00,0,0,0,0,0,0,0,0,0
2018-12-30 05:00:00,0,0,0,0,0,0,0,0,0
2018-12-30 06:00:00,0,0,0,11,0,0,0,0,11
2018-12-30 07:00:00,0,0,0,0,0,0,0,0,0
2018-12-30 08:00:00,0,0,0,11,0,0,0,0,11
2018-12-30 09:00:00,11,23,0,11,0,0,35,0,80
2018-12-30 10:00:00,23,0,0,11,0,23,11,0,68
2018-12-30 11:00:00,70,70,11,11,11,35,35,11,254
2018-12-30 12:00:00,94,129,11,0,59,118,236,0,647
2018-12-30 13:00:00,165,70,23,94,59,200,295,35,941
2018-12-30 14:00:00,212,165,0,11,94,106,330,0,918
2018-12-30 15:00:00,165,94,0,59,47,82,177,11,635
2018-12-30 16:00:00,35,59,23,0,35,23,23,0,198
2018-12-30 17:00:00,47,23,11,35,11,11,11,0,149
2018-12-30 18:00:00,23,0,0,11,0,0,23,0,57
2018-12-30 19:00:00,47,0,0,11,0,23,35,0,116
2018-12-30 20:00:00,23,0,0,11,0,0,47,0,81
2018-12-30 21:00:00,11,11,0,0,0,0,11,11,44
2018-12-30 22:00:00,11,0,0,11,11,0,0,0,33
2018-12-30 23:00:00,35,0,0,11,0,11,23,0,80
2018-12-31 00:00:00,0,0,0,0,0,0,11,23,34
2018-12-31 01:00:00,11,11,0,0,11,0,0,0,33
2018-12-31 02:00:00,0,0,0,0,0,0,0,0,0
2018-12-31 03:00:00,0,0,0,0,0,0,0,0,0
2018-12-31 04:00:00,0,0,0,0,0,0,0,0,0
2018-12-31 05:00:00,0,0,0,0,0,0,0,0,0
2018-12-31 06:00:00,0,0,0,0,0,0,0,11,11
2018-12-31 07:00:00,0,0,0,0,0,0,0,0,0
2018-12-31 08:00:00,11,0,0,0,11,0,11,0,33
2018-12-31 09:00:00,11,11,0,0,0,0,11,11,44
2018-12-31 10:00:00,35,11,0,0,0,0,11,0,57
2018-12-31 11:00:00,11,23,0,0,0,11,70,0,115
2018-12-31 12:00:00,23,59,0,11,0,35,106,11,245
2018-12-31 13:00:00,0,35,0,0,0,35,70,23,163
2018-12-31 14:00:00,23,106,0,0,11,0,35,11,186
2018-12-31 15:00:00,23,70,11,0,11,35,70,11,231
2018-12-31 16:00:00,59,0,0,11,11,11,23,0,115
2018-12-31 17:00:00,47,0,0,11,0,0,0,0,58
2018-12-31 18:00:00,11,0,11,11,0,0,0,11,44
2018-12-31 19:00:00,23,0,0,0,11,0,0,11,45
2018-12-31 20:00:00,11,0,0,0,0,0,35,0,46
2018-12-31 21:00:00,11,0,0,0,0,0,11,0,22
2018-12-31 22:00:00,0,0,0,0,0,0,11,0,11
2018-12-31 23:00:00,23,23,35,11,11,11,35,23,172
2019-01-01 00:00:00,47,35,70,11,0,0,11,47,221
2019-01-01 01:00:00,0,0,0,0,0,0,0,0,0
2019-01-01 02:00:00,23,11,0,11,0,11,23,0,79
2019-01-01 03:00:00,47,0,0,11,0,0,0,0,58
2019-01-01 04:00:00,0,0,0,0,0,0,0,0,0
2019-01-01 05:00:00,0,0,0,0,0,0,0,0,0
2019-01-01 06:00:00,0,0,0,0,0,0,0,0,0
2019-01-01 07:00:00,0,0,0,0,0,0,0,0,0
2019-01-01 08:00:00,0,0,0,0,0,0,11,0,11
2019-01-01 09:00:00,11,0,0,0,0,11,0,0,22
2019-01-01 10:00:00,11,0,11,0,23,11,0,0,56
2019-01-01 11:00:00,47,23,11,0,0,11,0,11,103
2019-01-01 12:00:00,70,94,23,0,23,70,35,59,374
2019-01-01 13:00:00,118,118,23,11,11,47,177,11,516
2019-01-01 14:00:00,82,94,35,82,47,129,70,11,550
2019-01-01 15:00:00,165,47,11,11,11,59,141,23,468
2019-01-01 16:00:00,141,23,11,11,11,11,0,11,219
2019-01-01 17:00:00,47,0,0,11,11,23,0,11,103
2019-01-01 18:00:00,11,47,0,11,0,0,11,11,91
2019-01-01 19:00:00,11,11,0,11,0,0,11,11,55
2019-01-01 20:00:00,0,0,0,0,0,0,0,0,0
2019-01-01 21:00:00,11,0,0,0,0,0,0,0,11
2019-01-01 22:00:00,11,0,0,0,0,0,11,0,22
2019-01-01 23:00:00,0,0,0,0,0,0,0,0,0
2019-01-02 00:00:00,0,0,0,0,0,0,0,0,0
2019-01-02 01:00:00,0,0,0,0,0,0,11,0,11
2019-01-02 02:00:00,0,0,0,0,0,0,0,0,0
2019-01-02 03:00:00,0,0,0,0,0,0,0,0,0
2019-01-02 04:00:00,11,0,0,0,0,0,0,0,11
2019-01-02 05:00:00,0,0,0,0,0,0,0,0,0
2019-01-02 06:00:00,47,0,0,11,0,0,11,0,69
2019-01-02 07:00:00,59,35,0,0,0,11,35,11,151
2019-01-02 08:00:00,106,47,11,0,0,11,23,0,198
2019-01-02 09:00:00,23,11,0,0,0,11,11,0,56
2019-01-02 10:00:00,35,59,23,47,23,0,35,11,233
2019-01-02 11:00:00,47,82,94,0,11,23,118,35,410
2019-01-02 12:00:00,236,94,47,0,11,106,188,23,705
2019-01-02 13:00:00,342,94,47,0,11,59,141,35,729
2019-01-02 14:00:00,129,106,47,35,47,47,318,0,729
2019-01-02 15:00:00,47,47,0,11,11,23,118,23,280
2019-01-02 16:00:00,129,11,23,11,0,70,47,35,326
2019-01-02 17:00:00,47,11,0,0,0,0,82,23,163
2019-01-02 18:00:00,23,35,0,0,0,11,23,23,115
2019-01-02 19:00:00,59,11,0,11,0,0,11,0,92
2019-01-02 20:00:00,11,11,0,0,11,0,11,0,44
2019-01-02 21:00:00,82,35,0,0,0,0,94,0,211
2019-01-02 22:00:00,11,0,0,0,0,11,0,0,22
2019-01-02 23:00:00,11,0,0,0,0,0,0,0,11
2019-01-03 00:00:00,11,0,0,0,0,0,0,0,11
2019-01-03 01:00:00,0,0,0,0,0,0,0,11,11
2019-01-03 02:00:00,0,0,0,0,0,0,0,0,0
2019-01-03 03:00:00,0,0,0,0,0,0,23,0,23
2019-01-03 04:00:00,0,0,0,0,0,0,0,0,0
2019-01-03 05:00:00,0,11,0,0,0,0,0,0,11
2019-01-03 06:00:00,47,0,0,0,0,11,0,0,58
2019-01-03 07:00:00,94,11,0,11,0,0,11,23,150
2019-01-03 08:00:00,47,23,0,0,0,11,35,35,151
2019-01-03 09:00:00,47,47,35,11,11,35,35,0,221
2019-01-03 10:00:00,70,47,35,23,11,0,47,23,256
2019-01-03 11:00:00,47,59,23,0,11,23,106,11,280
2019-01-03 12:00:00,94,23,11,11,0,11,118,11,279
2019-01-03 13:00:00,129,23,11,47,0,47,141,11,409
2019-01-03 14:00:00,188,47,23,11,0,35,153,35,492
2019-01-03 15:00:00,59,11,0,23,23,59,188,11,374
2019-01-03 16:00:00,94,0,0,11,35,0,165,11,316
2019-01-03 17:00:00,118,0,0,0,0,47,11,11,187
2019-01-03 18:00:00,70,11,35,11,11,23,11,0,172
2019-01-03 19:00:00,70,47,23,23,11,23,35,0,232
2019-01-03 20:00:00,23,47,0,11,11,23,35,0,150
2019-01-03 21:00:00,11,0,0,0,0,0,0,0,11
2019-01-03 22:00:00,0,11,0,0,0,11,0,0,22
2019-01-03 23:00:00,0,0,0,0,0,0,11,0,11
2019-01-04 00:00:00,0,0,0,0,0,0,0,0,0
2019-01-04 01:00:00,11,11,0,0,0,0,0,0,22
2019-01-04 02:00:00,0,0,0,0,0,0,0,0,0
2019-01-04 03:00:00,0,0,0,0,0,0,0,0,0
2019-01-04 04:00:00,0,0,0,0,0,0,11,0,11
2019-01-04 05:00:00,23,0,0,0,0,0,0,0,23
2019-01-04 06:00:00,35,0,0,0,0,0,23,0,58
2019-01-04 07:00:00,23,0,0,0,0,0,23,0,46
2019-01-04 08:00:00,94,35,23,11,0,0,11,94,268
2019-01-04 09:00:00,23,0,0,0,0,0,0,23,46
2019-01-04 10:00:00,35,0,11,0,0,0,35,11,92
2019-01-04 11:00:00,94,47,11,0,0,11,47,35,245
2019-01-04 12:00:00,118,59,11,0,0,59,129,47,423
2019-01-04 13:00:00,118,106,11,35,0,23,153,35,481
2019-01-04 14:00:00,94,59,0,0,0,0,94,59,306
2019-01-04 15:00:00,118,47,0,11,0,0,94,59,329
2019-01-04 16:00:00,59,11,0,0,0,0,23,11,104
2019-01-04 17:00:00,23,0,0,23,0,0,82,0,128
2019-01-04 18:00:00,11,23,0,23,11,35,70,11,184
2019-01-04 19:00:00,47,11,0,0,0,0,23,0,81
2019-01-04 20:00:00,23,23,0,0,0,0,35,11,92
2019-01-04 21:00:00,47,0,0,0,0,0,23,0,70
2019-01-04 22:00:00,11,0,11,11,0,0,35,0,68
2019-01-04 23:00:00,0,0,0,0,11,0,0,0,11
2019-01-05 00:00:00,23,0,0,0,0,11,11,0,45
2019-01-05 01:00:00,23,0,0,0,0,35,23,0,81
2019-01-05 02:00:00,23,0,0,0,0,0,11,0,34
2019-01-05 03:00:00,0,0,0,0,0,0,0,0,0
2019-01-05 04:00:00,0,0,0,0,0,0,0,0,0
2019-01-05 05:00:00,0,0,0,0,0,0,23,0,23
2019-01-05 06:00:00,0,0,0,0,0,0,0,0,0
2019-01-05 07:00:00,11,0,0,0,0,0,11,0,22
2019-01-05 08:00:00,11,0,0,0,0,0,59,0,70
2019-01-05 09:00:00,11,0,0,11,0,0,70,0,92
2019-01-05 10:00:00,47,11,0,11,0,0,11,23,103
2019-01-05 11:00:00,188,70,23,11,11,23,70,59,455
2019-01-05 12:00:00,236,82,0,11,11,59,354,35,788
2019-01-05 13:00:00,153,153,47,94,23,70,519,35,1094
2019-01-05 14:00:00,1026,165,11,70,47,82,472,35,1908
2019-01-05 15:00:00,153,106,0,35,0,82,472,0,848
2019-01-05 16:00:00,82,35,11,11,11,70,118,35,373
2019-01-05 17:00:00,82,11,0,11,23,0,82,0,209
2019-01-05 18:00:00,59,35,0,0,23,47,118,35,317
2019-01-05 19:00:00,11,23,0,0,0,11,11,0,56
2019-01-05 20:00:00,11,11,0,0,47,11,35,11,126
2019-01-05 21:00:00,11,11,11,0,0,11,23,23,90
2019-01-05 22:00:00,11,0,11,0,0,0,59,0,81
2019-01-05 23:00:00,11,0,0,0,11,0,35,11,68
2019-01-06 00:00:00,0,11,0,23,0,0,47,613,694
2019-01-06 01:00:00,0,11,0,0,11,0,0,660,682
2019-01-06 02:00:00,11,11,0,0,0,0,0,0,22
2019-01-06 03:00:00,11,0,0,0,0,23,23,0,57
2019-01-06 04:00:00,0,0,0,0,0,0,0,0,0
2019-01-06 05:00:00,0,0,0,0,0,0,0,0,0
2019-01-06 06:00:00,0,0,0,0,0,0,0,0,0
2019-01-06 07:00:00,0,11,0,0,0,0,11,0,22
2019-01-06 08:00:00,0,23,0,0,0,11,35,11,80
2019-01-06 09:00:00,11,11,0,0,23,0,11,11,67
2019-01-06 10:00:00,23,11,0,0,0,0,35,0,69
2019-01-06 11:00:00,70,11,0,0,35,47,247,11,421
2019-01-06 12:00:00,70,153,11,0,35,59,448,23,799
2019-01-06 13:00:00,224,106,23,35,47,94,177,59,765
2019-01-06 14:00:00,129,118,23,70,35,70,271,23,739
2019-01-06 15:00:00,212,47,0,35,23,59,165,11,552
2019-01-06 16:00:00,59,35,11,11,23,11,59,0,209
2019-01-06 17:00:00,47,23,0,0,0,11,47,0,128
2019-01-06 18:00:00,11,23,0,23,0,11,11,0,79
2019-01-06 19:00:00,0,11,0,0,0,47,23,0,81
2019-01-06 20:00:00,23,11,0,0,0,0,11,0,45
2019-01-06 21:00:00,11,11,0,0,0,0,11,0,33
2019-01-06 22:00:00,0,11,0,0,0,0,0,11,22
2019-01-06 23:00:00,0,0,0,0,0,0,0,0,0
2019-01-07 00:00:00,0,0,0,0,0,0,0,0,0
2019-01-07 01:00:00,0,0,0,0,0,0,0,0,0
2019-01-07 02:00:00,0,0,0,0,0,0,0,11,11
2019-01-07 03:00:00,0,0,0,0,0,0,0,0,0
2019-01-07 04:00:00,0,0,0,0,0,0,0,0,0
2019-01-07 05:00:00,47,11,0,0,0,0,11,0,69
2019-01-07 06:00:00,59,11,0,0,0,0,0,0,70
2019-01-07 07:00:00,35,0,0,23,0,11,35,47,151
2019-01-07 08:00:00,94,11,0,11,0,11,11,47,185
2019-01-07 09:00:00,11,0,0,0,23,23,47,11,115
2019-01-07 10:00:00,47,35,0,11,0,0,35,59,187
2019-01-07 11:00:00,23,11,0,11,11,35,59,0,150
2019-01-07 12:00:00,177,23,11,0,11,23,59,35,339
2019-01-07 13:00:00,70,35,0,23,0,0,23,11,162
2019-01-07 14:00:00,377,11,0,0,23,0,70,47,528
2019-01-07 15:00:00,165,23,35,47,0,11,82,23,386
2019-01-07 16:00:00,59,11,0,0,11,0,35,0,116
2019-01-07 17:00:00,35,70,0,0,11,0,23,0,139
2019-01-07 18:00:00,47,35,11,0,0,0,23,0,116
2019-01-07 19:00:00,11,0,0,0,0,0,0,11,22
2019-01-07 20:00:00,11,0,0,0,0,0,0,0,11
2019-01-07 21:00:00,11,11,23,0,0,11,0,0,56
2019-01-07 22:00:00,11,11,0,0,0,0,0,0,22
2019-01-07 23:00:00,11,0,0,0,0,0,0,0,11
2019-01-08 00:00:00,0,0,0,0,0,0,11,11,22
2019-01-08 01:00:00,0,0,0,0,0,0,11,0,11
2019-01-08 02:00:00,0,0,0,0,0,0,0,0,0
2019-01-08 03:00:00,0,0,0,0,0,0,0,0,0
2019-01-08 04:00:00,0,11,0,0,0,0,0,0,11
2019-01-08 05:00:00,11,0,0,0,0,0,0,0,11
2019-01-08 06:00:00,11,0,0,11,0,0,0,11,33
2019-01-08 07:00:00,0,23,0,47,0,0,23,59,152
2019-01-08 08:00:00,82,23,11,0,11,11,82,11,231
2019-01-08 09:00:00,35,0,11,0,0,0,11,11,68
2019-01-08 10:00:00,59,47,47,23,0,0,82,0,258
2019-01-08 11:00:00,94,70,35,35,47,0,70,23,374
2019-01-08 12:00:00,271,0,11,0,0,0,59,11,352
2019-01-08 13:00:00,59,47,0,23,59,11,47,35,281
2019-01-08 14:00:00,129,59,11,59,23,35,94,11,421
2019-01-08 15:00:00,59,11,47,0,11,0,118,23,269
2019-01-08 16:00:00,23,11,0,0,35,35,70,23,197
2019-01-08 17:00:00,70,0,0,0,11,11,11,0,103
2019-01-08 18:00:00,11,35,23,11,35,35,11,0,161
2019-01-08 19:00:00,11,23,11,0,23,0,11,0,79
2019-01-08 20:00:00,11,11,35,0,0,0,59,0,116
2019-01-08 21:00:00,0,0,11,0,0,0,11,0,22
2019-01-08 22:00:00,0,0,0,0,0,0,11,11,22
2019-01-08 23:00:00,0,0,0,0,0,0,0,0,0
2019-01-09 00:00:00,0,0,0,0,0,0,0,11,11
2019-01-09 01:00:00,0,0,0,0,0,0,0,0,0
2019-01-09 02:00:00,0,0,11,0,0,0,0,0,11
2019-01-09 03:00:00,0,0,0,0,0,0,0,0,0
2019-01-09 04:00:00,0,0,0,0,0,0,0,0,0
2019-01-09 05:00:00,0,0,0,0,0,0,0,0,0
2019-01-09 06:00:00,23,0,0,11,0,0,0,11,45
2019-01-09 07:00:00,94,0,0,23,0,0,35,35,187
2019-01-09 08:00:00,82,0,35,0,0,0,11,82,210
2019-01-09 09:00:00,82,35,11,0,35,11,23,35,232
2019-01-09 10:00:00,59,11,0,0,0,0,0,0,70
2019-01-09 11:00:00,59,35,23,23,23,35,35,0,233
2019-01-09 12:00:00,129,23,0,23,23,35,70,47,350
2019-01-09 13:00:00,82,70,0,11,47,23,59,23,315
2019-01-09 14:00:00,129,35,11,23,23,47,82,82,432
2019-01-09 15:00:00,106,59,23,0,0,11,70,47,316
2019-01-09 16:00:00,70,11,0,0,35,11,94,59,280
2019-01-09 17:00:00,47,35,11,0,0,11,35,11,150
2019-01-09 18:00:00,59,11,0,11,35,11,23,0,150
2019-01-09 19:00:00,47,11,0,11,11,0,0,11,91
2019-01-09 20:00:00,0,35,11,0,0,35,11,0,92
2019-01-09 21:00:00,0,0,0,11,0,11,0,0,22
2019-01-09 22:00:00,0,0,0,23,0,0,0,0,23
2019-01-09 23:00:00,0,0,0,0,0,0,0,0,0
2019-01-10 00:00:00,0,0,0,0,0,0,0,0,0
2019-01-10 01:00:00,0,0,0,0,0,0,0,0,0
2019-01-10 02:00:00,0,0,0,0,0,0,0,11,11
2019-01-10 03:00:00,11,0,0,0,0,0,0,0,11
2019-01-10 04:00:00,0,0,0,0,0,0,0,11,11
2019-01-10 05:00:00,11,0,0,0,0,0,0,0,11
2019-01-10 06:00:00,47,11,0,0,0,0,23,0,81
2019-01-10 07:00:00,47,23,11,0,0,0,23,59,163
2019-01-10 08:00:00,59,23,35,0,11,0,11,94,233
2019-01-10 09:00:00,59,11,35,0,0,0,35,11,151
2019-01-10 10:00:00,70,47,23,11,11,11,59,23,255
2019-01-10 11:00:00,59,23,23,0,11,11,47,0,174
2019-01-10 12:00:00,94,59,59,0,23,59,82,35,411
2019-01-10 13:00:00,153,106,11,0,0,23,118,0,411
2019-01-10 14:00:00,177,70,23,23,23,0,129,11,456
2019-01-10 15:00:00,70,23,47,11,11,11,94,11,278
2019-01-10 16:00:00,106,35,0,0,0,23,23,35,222
2019-01-10 17:00:00,35,23,0,0,35,23,70,0,186
2019-01-10 18:00:00,59,11,11,0,0,11,11,0,103
2019-01-10 19:00:00,35,23,0,11,11,35,23,0,138
2019-01-10 20:00:00,35,11,0,0,0,11,35,0,92
2019-01-10 21:00:00,23,0,0,0,0,0,23,0,46
2019-01-10 22:00:00,11,11,0,0,0,11,0,0,33
2019-01-10 23:00:00,11,0,0,0,0,11,0,0,22
2019-01-11 00:00:00,0,0,0,0,0,0,0,0,0
2019-01-11 01:00:00,0,0,0,0,0,0,0,0,0
2019-01-11 02:00:00,11,0,0,0,0,0,0,0,11
2019-01-11 03:00:00,0,0,0,0,0,0,0,0,0
2019-01-11 04:00:00,0,0,0,0,0,0,0,0,0
2019-01-11 05:00:00,0,0,0,0,0,0,0,0,0
2019-01-11 06:00:00,11,0,0,0,0,0,0,0,11
2019-01-11 07:00:00,153,23,0,0,0,11,82,23,292
2019-01-11 08:00:00,94,23,11,11,0,0,23,59,221
2019-01-11 09:00:00,11,82,11,0,0,11,11,0,126
2019-01-11 10:00:00,11,35,11,0,11,11,118,11,208
2019-01-11 11:00:00,177,23,0,11,0,11,118,35,375
2019-01-11 12:00:00,247,59,0,23,11,11,212,165,728
2019-01-11 13:00:00,141,59,0,47,11,106,283,47,694
2019-01-11 14:00:00,118,188,0,70,11,35,224,11,657
2019-01-11 15:00:00,82,35,0,11,0,23,106,11,268
2019-01-11 16:00:00,47,11,0,0,0,11,118,0,187
2019-01-11 17:00:00,59,0,0,0,11,11,94,35,210
2019-01-11 18:00:00,35,35,0,0,11,0,47,11,139
2019-01-11 19:00:00,59,0,11,0,0,11,47,23,151
2019-01-11 20:00:00,11,0,0,0,0,0,0,11,22
2019-01-11 21:00:00,0,0,0,0,0,0,0,0,0
2019-01-11 22:00:00,0,0,0,0,0,0,23,0,23
2019-01-11 23:00:00,23,0,0,0,0,0,11,0,34
2019-01-12 00:00:00,0,0,0,11,0,0,11,11,33
2019-01-12 01:00:00,23,0,0,0,0,35,0,0,58
2019-01-12 02:00:00,35,0,0,0,0,0,11,11,57
2019-01-12 03:00:00,0,0,0,0,0,0,0,11,11
2019-01-12 04:00:00,0,0,0,0,0,0,0,0,0
2019-01-12 05:00:00,0,0,0,0,0,0,0,0,0
2019-01-12 06:00:00,23,0,0,0,0,0,23,23,69
2019-01-12 07:00:00,23,0,0,0,0,0,11,0,34
2019-01-12 08:00:00,47,23,0,0,0,11,35,0,116
2019-01-12 09:00:00,11,0,0,0,0,0,59,23,93
2019-01-12 10:00:00,35,23,11,23,23,23,82,11,231
2019-01-12 11:00:00,59,141,11,23,0,59,106,35,434
2019-01-12 12:00:00,507,35,0,70,35,70,247,118,1082
2019-01-12 13:00:00,106,448,0,70,23,94,283,35,1059
2019-01-12 14:00:00,153,94,11,11,0,59,507,70,905
2019-01-12 15:00:00,47,59,0,47,11,59,247,47,517
2019-01-12 16:00:00,259,35,0,11,11,23,129,11,479
2019-01-12 17:00:00,94,11,0,11,23,47,94,0,280
2019-01-12 18:00:00,118,11,0,0,0,0,106,0,235
2019-01-12 19:00:00,35,0,0,11,11,0,35,11,103
2019-01-12 20:00:00,23,23,0,11,11,0,47,11,126
2019-01-12 21:00:00,23,0,0,0,11,11,0,0,45
2019-01-12 22:00:00,47,0,0,0,11,0,23,11,92
2019-01-12 23:00:00,11,0,0,0,11,0,59,0,81
2019-01-13 00:00:00,23,0,0,0,11,0,11,0,45
2019-01-13 01:00:00,0,0,0,11,11,11,23,0,56
2019-01-13 02:00:00,23,0,0,0,0,0,11,0,34
2019-01-13 03:00:00,0,0,0,0,0,11,0,0,11
2019-01-13 04:00:00,0,0,0,0,0,23,0,0,23
2019-01-13 05:00:00,0,0,0,0,0,0,0,0,0
2019-01-13 06:00:00,0,0,0,0,0,0,0,0,0
2019-01-13 07:00:00,0,0,0,0,0,0,23,0,23
2019-01-13 08:00:00,188,0,0,0,0,0,0,47,235
2019-01-13 09:00:00,11,0,0,0,0,0,23,11,45
2019-01-13 10:00:00,23,0,0,0,0,0,35,11,69
2019-01-13 11:00:00,23,35,11,0,0,47,59,0,175
2019-01-13 12:00:00,23,70,11,11,11,82,200,23,431
2019-01-13 13:00:00,177,118,0,11,35,118,330,23,812
2019-01-13 14:00:00,165,153,0,35,59,70,708,70,1260
2019-01-13 15:00:00,165,153,0,47,35,0,200,0,600
2019-01-13 16:00:00,70,47,23,11,35,11,118,11,326
2019-01-13 17:00:00,70,11,0,11,11,11,94,0,208
2019-01-13 18:00:00,0,0,0,0,0,0,0,23,23
2019-01-13 19:00:00,23,0,0,0,11,0,0,11,45
2019-01-13 20:00:00,23,11,23,0,0,0,23,11,91
2019-01-13 21:00:00,0,11,11,0,11,0,0,11,44
2019-01-13 22:00:00,11,11,0,0,0,0,11,0,33
2019-01-13 23:00:00,0,0,0,0,0,0,0,0,0
2019-01-14 00:00:00,0,0,0,0,0,0,0,0,0
2019-01-14 01:00:00,0,0,0,0,0,0,0,0,0
2019-01-14 02:00:00,11,0,0,0,0,0,0,0,11
2019-01-14 03:00:00,0,0,0,0,0,0,0,0,0
2019-01-14 04:00:00,0,0,0,0,0,0,0,0,0
2019-01-14 05:00:00,23,0,0,0,0,0,0,0,23
2019-01-14 06:00:00,35,0,0,0,0,0,11,0,46
2019-01-14 07:00:00,70,35,0,11,0,0,47,59,222
2019-01-14 08:00:00,106,35,23,11,23,11,11,70,290
2019-01-14 09:00:00,94,118,23,0,0,0,70,23,328
2019-01-14 10:00:00,106,35,35,11,0,23,141,11,362
2019-01-14 11:00:00,94,47,70,23,0,11,59,35,339
2019-01-14 12:00:00,47,82,82,0,0,0,70,11,292
2019-01-14 13:00:00,35,35,82,0,11,106,82,0,351
2019-01-14 14:00:00,236,82,11,35,11,0,129,23,527
2019-01-14 15:00:00,153,59,0,0,23,11,153,82,481
2019-01-14 16:00:00,82,0,0,11,11,11,47,0,162
2019-01-14 17:00:00,47,0,0,0,0,23,23,0,93
2019-01-14 18:00:00,70,11,0,0,0,11,35,35,162
2019-01-14 19:00:00,35,0,0,0,0,0,23,11,69
2019-01-14 20:00:00,11,23,0,11,0,0,11,0,56
2019-01-14 21:00:00,0,0,0,11,0,11,11,0,33
2019-01-14 22:00:00,0,0,0,0,0,11,0,0,11
2019-01-14 23:00:00,0,0,0,11,0,0,0,11,22
2019-01-15 00:00:00,0,0,0,0,0,0,0,0,0
2019-01-15 01:00:00,23,0,0,0,0,0,23,0,46
2019-01-15 02:00:00,0,0,0,0,0,0,0,0,0
2019-01-15 03:00:00,0,0,0,0,0,0,0,0,0
2019-01-15 04:00:00,0,0,0,0,0,0,0,11,11
2019-01-15 05:00:00,35,0,0,0,0,0,23,0,58
2019-01-15 06:00:00,35,11,0,0,0,11,0,0,57
2019-01-15 07:00:00,82,35,0,11,0,0,11,23,162
2019-01-15 08:00:00,82,35,11,23,0,0,35,153,339
2019-01-15 09:00:00,47,11,23,23,11,0,70,35,220
2019-01-15 10:00:00,212,94,59,0,11,23,70,47,516
2019-01-15 11:00:00,94,212,0,23,0,0,94,47,470
2019-01-15 12:00:00,129,11,23,0,23,35,129,35,385
2019-01-15 13:00:00,47,35,11,23,11,23,106,35,291
2019-01-15 14:00:00,224,23,23,0,23,11,82,11,397
2019-01-15 15:00:00,82,11,0,11,0,23,94,35,256
2019-01-15 16:00:00,47,35,0,0,23,23,59,35,222
2019-01-15 17:00:00,82,59,0,0,11,0,70,0,222
2019-01-15 18:00:00,0,47,0,0,23,35,35,11,151
2019-01-15 19:00:00,23,94,0,47,11,11,82,0,268
2019-01-15 20:00:00,70,35,0,0,0,11,0,11,127
2019-01-15 21:00:00,11,11,0,23,0,35,35,0,115
2019-01-15 22:00:00,0,0,0,0,0,0,0,11,11
2019-01-15 23:00:00,0,0,0,0,0,0,0,0,0
2019-01-16 00:00:00,0,0,0,0,0,0,0,0,0
2019-01-16 01:00:00,0,0,0,0,0,0,0,0,0
2019-01-16 02:00:00,0,0,0,0,0,0,0,0,0
2019-01-16 03:00:00,0,0,0,0,0,0,0,0,0
2019-01-16 04:00:00,0,11,0,0,0,0,0,0,11
2019-01-16 05:00:00,35,0,0,0,0,0,0,0,35
2019-01-16 06:00:00,35,0,0,0,0,11,23,11,80
2019-01-16 07:00:00,82,35,0,0,0,0,59,23,199
2019-01-16 08:00:00,59,0,0,0,0,11,35,35,140
2019-01-16 09:00:00,35,11,0,11,0,11,35,23,126
2019-01-16 10:00:00,47,11,35,23,11,11,35,11,184
2019-01-16 11:00:00,35,23,0,0,11,0,47,0,116
2019-01-16 12:00:00,118,35,11,11,0,11,118,35,339
2019-01-16 13:00:00,35,11,11,23,0,11,23,11,125
2019-01-16 14:00:00,153,106,23,23,11,0,70,47,433
2019-01-16 15:00:00,70,35,11,0,35,11,70,11,243
2019-01-16 16:00:00,94,59,11,0,35,23,82,35,339
2019-01-16 17:00:00,47,224,0,0,0,0,35,0,306
2019-01-16 18:00:00,106,23,11,0,11,11,47,0,209
2019-01-16 19:00:00,35,11,0,0,11,0,0,0,57
2019-01-16 20:00:00,23,11,0,23,0,11,11,0,79
2019-01-16 21:00:00,11,141,0,94,0,0,11,11,268
2019-01-16 22:00:00,23,23,0,0,11,11,11,0,79
2019-01-16 23:00:00,35,0,0,0,0,0,11,0,46
2019-01-17 00:00:00,0,0,0,0,0,0,11,0,11
2019-01-17 01:00:00,0,0,0,0,0,0,11,11,22
2019-01-17 02:00:00,11,0,0,0,0,0,0,0,11
2019-01-17 03:00:00,0,0,0,0,0,0,11,0,11
2019-01-17 04:00:00,0,0,0,0,0,0,11,0,11
2019-01-17 05:00:00,23,0,0,0,0,0,11,0,34
2019-01-17 06:00:00,59,0,0,0,0,11,23,0,93
2019-01-17 07:00:00,82,11,0,0,0,0,23,35,151
2019-01-17 08:00:00,94,35,11,0,23,0,47,59,269
2019-01-17 09:00:00,82,23,11,0,0,11,106,0,233
2019-01-17 10:00:00,118,23,23,35,0,11,82,11,303
2019-01-17 11:00:00,70,11,0,0,11,23,82,11,208
2019-01-17 12:00:00,165,23,0,0,0,35,82,47,352
2019-01-17 13:00:00,70,59,23,0,11,11,70,59,303
2019-01-17 14:00:00,129,59,23,0,11,23,118,247,610
2019-01-17 15:00:00,106,70,23,23,23,11,129,23,408
2019-01-17 16:00:00,106,35,11,11,0,0,94,11,268
2019-01-17 17:00:00,35,47,0,11,35,35,47,0,210
2019-01-17 18:00:00,0,11,0,0,0,0,59,0,70
2019-01-17 19:00:00,11,11,0,0,0,0,23,0,45
2019-01-17 20:00:00,11,11,0,0,0,0,11,0,33
2019-01-17 21:00:00,0,0,0,0,0,0,0,0,0
2019-01-17 22:00:00,0,0,0,0,0,0,0,0,0
2019-01-17 23:00:00,0,0,0,0,0,0,0,0,0
2019-01-18 00:00:00,0,0,0,0,0,0,23,0,23
2019-01-18 01:00:00,0,0,0,0,0,0,59,0,59
2019-01-18 02:00:00,0,0,0,0,0,0,23,0,23
2019-01-18 03:00:00,0,0,0,0,0,0,35,0,35
2019-01-18 04:00:00,0,0,11,0,0,0,11,0,22
2019-01-18 05:00:00,35,0,0,0,0,0,23,11,69
2019-01-18 06:00:00,11,0,0,0,0,0,11,0,22
2019-01-18 07:00:00,118,11,0,11,0,0,11,23,174
2019-01-18 08:00:00,59,11,0,0,0,0,23,82,175
2019-01-18 09:00:00,70,11,47,11,0,0,23,0,162
2019-01-18 10:00:00,35,23,70,0,0,0,47,11,186
2019-01-18 11:00:00,118,35,59,0,0,0,94,23,329
2019-01-18 12:00:00,129,35,59,35,0,0,106,70,434
2019-01-18 13:00:00,118,59,11,23,11,0,70,35,327
2019-01-18 14:00:00,141,23,11,11,11,11,94,23,325
2019-01-18 15:00:00,35,11,23,0,0,0,59,11,139
2019-01-18 16:00:00,11,23,35,0,0,0,23,11,103
2019-01-18 17:00:00,11,0,11,0,0,0,0,0,22
2019-01-18 18:00:00,0,0,0,0,0,0,0,0,0
2019-01-18 19:00:00,0,0,11,0,0,0,0,0,11
2019-01-18 20:00:00,0,0,0,0,0,0,0,0,0
2019-01-18 21:00:00,0,0,0,0,0,0,0,0,0
2019-01-18 22:00:00,0,0,0,11,0,0,0,0,11
2019-01-18 23:00:00,0,0,0,0,0,0,11,0,11
2019-01-19 00:00:00,11,0,0,0,0,11,0,0,22
2019-01-19 01:00:00,11,0,0,0,0,23,11,11,56
2019-01-19 02:00:00,11,0,0,0,0,11,35,0,57
2019-01-19 03:00:00,11,0,0,11,11,11,11,0,55
2019-01-19 04:00:00,0,0,0,0,0,0,11,0,11
2019-01-19 05:00:00,0,11,11,0,0,0,0,0,22
2019-01-19 06:00:00,0,0,11,0,0,0,0,0,11
2019-01-19 07:00:00,11,0,0,0,0,0,35,0,46
2019-01-19 08:00:00,11,11,11,0,0,0,70,0,103
2019-01-19 09:00:00,11,23,11,0,0,0,35,0,80
2019-01-19 10:00:00,23,47,11,0,23,35,165,0,304
2019-01-19 11:00:00,70,82,47,35,82,70,106,0,492
2019-01-19 12:00:00,141,118,0,35,70,94,377,11,846
2019-01-19 13:00:00,330,165,11,177,70,141,365,70,1329
2019-01-19 14:00:00,153,82,0,35,35,47,153,11,516
2019-01-19 15:00:00,47,23,23,0,0,11,59,0,163
2019-01-19 16:00:00,35,23,11,0,0,11,35,11,126
2019-01-19 17:00:00,35,0,0,0,0,0,59,11,105
2019-01-19 18:00:00,0,23,0,0,11,0,11,0,45
2019-01-19 19:00:00,0,0,0,0,11,0,0,0,11
2019-01-19 20:00:00,11,0,0,11,0,0,11,0,33
2019-01-19 21:00:00,0,0,0,0,0,0,0,0,0
2019-01-19 22:00:00,0,0,0,0,0,0,0,0,0
2019-01-19 23:00:00,0,0,0,11,0,0,0,0,11
2019-01-20 00:00:00,23,0,0,23,11,11,11,0,79
2019-01-20 01:00:00,23,0,0,0,0,0,35,11,69
2019-01-20 02:00:00,23,11,0,0,0,0,47,0,81
2019-01-20 03:00:00,0,0,0,0,0,0,59,0,59
2019-01-20 04:00:00,0,0,0,0,0,0,11,0,11
2019-01-20 05:00:00,0,11,0,0,0,0,0,0,11
2019-01-20 06:00:00,0,0,0,0,0,0,0,0,0
2019-01-20 07:00:00,0,0,0,0,0,0,11,0,11
2019-01-20 08:00:00,0,11,0,0,0,0,35,11,57
2019-01-20 09:00:00,23,11,0,0,0,0,11,0,45
2019-01-20 10:00:00,0,11,23,11,11,0,70,0,126
2019-01-20 11:00:00,82,47,0,47,0,35,94,23,328
2019-01-20 12:00:00,129,129,35,35,23,118,259,23,751
2019-01-20 13:00:00,106,224,0,70,70,82,601,35,1188
2019-01-20 14:00:00,247,188,0,59,70,70,696,59,1389
2019-01-20 15:00:00,165,200,0,59,59,82,200,59,824
2019-01-20 16:00:00,94,23,0,0,47,35,141,23,363
2019-01-20 17:00:00,82,11,11,0,23,0,70,11,208
2019-01-20 18:00:00,11,0,11,23,0,23,23,0,91
2019-01-20 19:00:00,47,0,0,0,0,11,82,0,140
2019-01-20 20:00:00,11,11,0,0,0,0,47,0,69
2019-01-20 21:00:00,23,11,0,0,0,0,0,0,34
2019-01-20 22:00:00,0,11,0,0,0,0,0,0,11
2019-01-20 23:00:00,0,0,0,0,0,0,0,0,0
2019-01-21 00:00:00,0,0,0,0,0,11,0,0,11
2019-01-21 01:00:00,0,0,0,0,0,0,0,11,11
2019-01-21 02:00:00,0,0,0,0,0,0,11,0,11
2019-01-21 03:00:00,0,0,0,0,0,0,35,0,35
2019-01-21 04:00:00,0,0,0,0,0,0,11,0,11
2019-01-21 05:00:00,47,0,0,0,0,0,11,11,69
2019-01-21 06:00:00,47,0,0,0,0,0,0,0,47
2019-01-21 07:00:00,118,35,11,11,0,11,47,0,233
2019-01-21 08:00:00,70,23,35,11,0,0,23,129,291
2019-01-21 09:00:00,23,0,106,0,0,11,35,0,175
2019-01-21 10:00:00,94,70,35,11,11,23,35,35,314
2019-01-21 11:00:00,106,70,23,11,0,0,106,0,316
2019-01-21 12:00:00,35,94,47,47,0,11,59,59,352
2019-01-21 13:00:00,106,59,23,23,35,11,59,35,351
2019-01-21 14:00:00,165,70,59,0,35,23,118,59,529
2019-01-21 15:00:00,153,59,59,11,11,11,70,23,397
2019-01-21 16:00:00,94,59,11,11,0,0,118,23,316
2019-01-21 17:00:00,11,11,23,0,0,0,47,0,92
2019-01-21 18:00:00,11,0,0,0,0,0,23,0,34
2019-01-21 19:00:00,11,0,0,0,0,0,0,0,11
2019-01-21 20:00:00,0,0,0,0,0,0,0,0,0
2019-01-21 21:00:00,0,0,0,0,0,0,0,0,0
2019-01-21 22:00:00,0,0,0,0,0,0,0,0,0
2019-01-21 23:00:00,11,0,0,0,0,0,11,0,22
2019-01-22 00:00:00,0,0,0,0,0,0,11,0,11
2019-01-22 01:00:00,0,0,0,0,0,0,11,0,11
2019-01-22 02:00:00,0,0,0,0,0,0,0,0,0
2019-01-22 03:00:00,0,0,11,0,0,0,0,0,11
2019-01-22 04:00:00,0,0,0,0,0,0,0,0,0
2019-01-22 05:00:00,23,0,0,0,0,0,11,0,34
2019-01-22 06:00:00,35,11,0,0,0,11,23,23,103
2019-01-22 07:00:00,106,11,47,0,0,0,59,23,246
2019-01-22 08:00:00,70,23,70,11,0,0,35,94,303
2019-01-22 09:00:00,35,23,35,23,0,0,35,23,174
2019-01-22 10:00:00,47,11,59,0,11,0,94,35,257
2019-01-22 11:00:00,106,35,47,0,11,23,47,35,304
2019-01-22 12:00:00,129,47,47,0,11,11,82,59,386
2019-01-22 13:00:00,94,35,35,11,0,23,70,47,315
2019-01-22 14:00:00,94,59,35,47,11,35,82,23,386
2019-01-22 15:00:00,141,106,35,35,47,35,70,47,516
2019-01-22 16:00:00,70,35,11,0,23,23,106,11,279
2019-01-22 17:00:00,106,0,0,0,0,11,70,11,198
2019-01-22 18:00:00,11,11,11,11,23,23,35,11,136
2019-01-22 19:00:00,59,23,23,0,0,11,23,11,150
2019-01-22 20:00:00,0,11,23,11,11,11,11,0,78
2019-01-22 21:00:00,11,11,0,0,11,11,47,11,102
2019-01-22 22:00:00,0,0,0,0,0,0,11,0,11
2019-01-22 23:00:00,0,0,0,0,0,0,23,0,23
2019-01-23 00:00:00,0,0,0,0,0,0,0,0,0
2019-01-23 01:00:00,11,0,0,0,0,0,0,11,22
2019-01-23 02:00:00,11,0,0,0,0,0,0,11,22
2019-01-23 03:00:00,0,0,0,0,0,0,0,0,0
2019-01-23 04:00:00,0,0,0,0,0,0,0,0,0
2019-01-23 05:00:00,0,0,0,0,0,0,35,0,35
2019-01-23 06:00:00,23,11,11,11,11,0,35,0,102
2019-01-23 07:00:00,141,35,23,35,0,11,59,70,374
2019-01-23 08:00:00,59,11,23,0,0,0,59,153,305
2019-01-23 09:00:00,47,0,47,0,11,0,11,0,116
2019-01-23 10:00:00,47,59,59,0,23,23,35,35,281
2019-01-23 11:00:00,70,11,59,11,0,0,70,23,244
2019-01-23 12:00:00,82,47,47,0,11,47,129,23,386
2019-01-23 13:00:00,70,59,23,11,0,35,94,23,315
2019-01-23 14:00:00,165,23,23,35,0,11,141,59,457
2019-01-23 15:00:00,129,35,82,11,11,11,129,23,431
2019-01-23 16:00:00,82,153,23,59,0,23,118,23,481
2019-01-23 17:00:00,23,35,0,35,0,11,11,11,126
2019-01-23 18:00:00,0,0,11,0,11,11,35,0,68
2019-01-23 19:00:00,47,11,11,11,0,23,35,35,173
2019-01-23 20:00:00,35,0,0,0,0,0,35,0,70
2019-01-23 21:00:00,11,0,0,0,0,0,0,0,11
2019-01-23 22:00:00,0,0,0,0,11,0,0,0,11
2019-01-23 23:00:00,0,0,0,0,0,0,0,0,0
2019-01-24 00:00:00,0,0,0,0,0,0,0,23,23
2019-01-24 01:00:00,0,0,0,0,0,0,11,11,22
2019-01-24 02:00:00,11,0,0,0,0,0,11,0,22
2019-01-24 03:00:00,0,0,0,0,0,11,11,0,22
2019-01-24 04:00:00,0,0,0,0,0,0,0,0,0
2019-01-24 05:00:00,0,0,0,0,0,0,11,0,11
2019-01-24 06:00:00,23,11,11,0,0,0,23,0,68
2019-01-24 07:00:00,129,11,11,0,0,0,23,0,174
2019-01-24 08:00:00,129,11,35,0,0,11,82,94,362
2019-01-24 09:00:00,94,23,47,11,0,11,59,0,245
2019-01-24 10:00:00,94,82,35,23,23,11,59,23,350
2019-01-24 11:00:00,70,82,0,11,35,35,106,11,350
2019-01-24 12:00:00,188,94,70,47,23,11,177,23,633
2019-01-24 13:00:00,94,59,23,11,11,35,236,11,480
2019-01-24 14:00:00,200,35,82,0,0,11,165,82,575
2019-01-24 15:00:00,70,47,23,35,0,23,118,35,351
2019-01-24 16:00:00,35,47,0,11,47,11,82,47,280
2019-01-24 17:00:00,0,0,11,11,0,0,11,0,33
2019-01-24 18:00:00,0,11,0,0,23,23,0,0,57
2019-01-24 19:00:00,0,0,0,0,11,11,23,11,56
2019-01-24 20:00:00,11,0,0,0,0,0,11,0,22
2019-01-24 21:00:00,11,0,0,0,0,0,0,0,11
2019-01-24 22:00:00,0,0,0,0,0,0,0,11,11
2019-01-24 23:00:00,0,0,0,0,0,0,0,0,0
2019-01-25 00:00:00,0,0,0,0,0,0,0,0,0
2019-01-25 01:00:00,0,0,0,0,0,0,11,0,11
2019-01-25 02:00:00,0,0,0,0,0,0,0,0,0
2019-01-25 03:00:00,11,0,0,0,0,0,0,0,11
2019-01-25 04:00:00,11,0,0,0,0,0,0,0,11
2019-01-25 05:00:00,11,0,0,0,0,0,0,0,11
2019-01-25 06:00:00,23,11,11,0,0,0,11,0,56
2019-01-25 07:00:00,141,11,35,23,0,0,70,23,303
2019-01-25 08:00:00,129,23,70,0,0,11,35,94,362
2019-01-25 09:00:00,47,11,35,11,0,11,35,0,150
2019-01-25 10:00:00,82,11,47,11,0,11,177,11,350
2019-01-25 11:00:00,165,11,23,11,11,11,188,11,431
2019-01-25 12:00:00,94,59,59,11,23,11,224,35,516
2019-01-25 13:00:00,295,106,59,0,11,23,59,11,564
2019-01-25 14:00:00,224,59,11,59,0,11,106,47,517
2019-01-25 15:00:00,47,11,11,23,11,47,70,23,243
2019-01-25 16:00:00,129,11,0,11,11,35,82,11,290
2019-01-25 17:00:00,118,23,11,11,0,11,70,0,244
2019-01-25 18:00:00,82,47,0,0,0,0,59,0,188
2019-01-25 19:00:00,35,0,0,0,0,11,23,35,104
2019-01-25 20:00:00,0,0,0,0,0,0,11,0,11
2019-01-25 21:00:00,0,0,0,11,0,0,11,0,22
2019-01-25 22:00:00,11,0,0,0,0,11,23,0,45
2019-01-25 23:00:00,47,0,0,0,11,0,0,11,69
2019-01-26 00:00:00,59,0,0,11,11,47,11,0,139
2019-01-26 01:00:00,0,0,0,23,0,35,0,35,93
2019-01-26 02:00:00,23,0,0,0,0,0,0,23,46
2019-01-26 03:00:00,0,11,0,0,0,11,0,0,22
2019-01-26 04:00:00,11,0,0,0,0,0,0,0,11
2019-01-26 05:00:00,11,0,0,0,0,0,0,0,11
2019-01-26 06:00:00,0,0,0,0,0,0,0,0,0
2019-01-26 07:00:00,0,0,0,0,0,0,11,0,11
2019-01-26 08:00:00,23,0,0,0,0,0,23,23,69
2019-01-26 09:00:00,23,0,0,0,0,11,35,0,69
2019-01-26 10:00:00,35,35,0,0,23,23,118,35,269
2019-01-26 11:00:00,129,141,0,23,35,47,153,23,551
2019-01-26 12:00:00,247,413,11,35,59,59,271,82,1177
2019-01-26 13:00:00,224,318,11,23,153,153,448,23,1353
2019-01-26 14:00:00,212,247,0,47,23,82,495,11,1117
2019-01-26 15:00:00,389,188,11,47,11,94,295,11,1046
2019-01-26 16:00:00,94,153,11,47,35,11,70,23,444
2019-01-26 17:00:00,11,23,11,0,23,0,47,0,115
2019-01-26 18:00:00,23,11,0,0,0,0,47,0,81
2019-01-26 19:00:00,0,0,11,0,0,11,11,11,44
2019-01-26 20:00:00,0,0,11,0,11,23,0,0,45
2019-01-26 21:00:00,23,0,0,0,0,0,0,11,34
2019-01-26 22:00:00,0,0,0,0,0,11,11,0,22
2019-01-26 23:00:00,11,0,0,0,0,0,0,11,22
2019-01-27 00:00:00,23,0,23,0,0,0,47,0,93
2019-01-27 01:00:00,0,0,0,0,0,23,11,0,34
2019-01-27 02:00:00,23,0,0,0,0,0,0,0,23
2019-01-27 03:00:00,0,0,0,0,0,11,23,0,34
2019-01-27 04:00:00,0,0,0,0,0,0,11,0,11
2019-01-27 05:00:00,0,0,0,0,0,0,0,0,0
2019-01-27 06:00:00,0,0,0,0,0,0,0,0,0
2019-01-27 07:00:00,0,0,0,0,0,0,23,0,23
2019-01-27 08:00:00,0,0,0,0,0,0,23,0,23
2019-01-27 09:00:00,0,0,0,0,0,0,23,0,23
2019-01-27 10:00:00,23,47,0,11,0,0,59,0,140
2019-01-27 11:00:00,23,153,0,35,11,47,165,47,481
2019-01-27 12:00:00,59,94,23,59,59,118,188,0,600
2019-01-27 13:00:00,47,118,11,23,11,47,342,23,622
2019-01-27 14:00:00,82,47,0,11,35,59,224,11,469
2019-01-27 15:00:00,82,82,0,11,0,11,129,0,315
2019-01-27 16:00:00,11,23,0,11,11,23,70,0,149
2019-01-27 17:00:00,82,0,0,0,0,23,106,0,211
2019-01-27 18:00:00,23,0,0,23,11,0,35,0,92
2019-01-27 19:00:00,70,23,0,0,11,11,35,11,161
2019-01-27 20:00:00,35,0,11,0,0,11,23,11,91
2019-01-27 21:00:00,11,0,0,0,0,35,11,0,57
2019-01-27 22:00:00,35,0,0,11,0,11,0,11,68
2019-01-27 23:00:00,11,0,0,0,11,0,11,0,33
2019-01-28 00:00:00,0,0,0,0,0,11,0,0,11
2019-01-28 01:00:00,0,0,0,0,0,0,0,23,23
2019-01-28 02:00:00,0,0,0,0,0,0,0,11,11
2019-01-28 03:00:00,0,0,0,0,0,0,0,23,23
2019-01-28 04:00:00,11,11,0,0,0,0,0,0,22
2019-01-28 05:00:00,0,0,0,0,0,0,11,11,22
2019-01-28 06:00:00,82,11,11,0,0,0,47,0,151
2019-01-28 07:00:00,82,11,0,11,0,0,0,23,127
2019-01-28 08:00:00,94,23,23,0,11,23,35,129,338
2019-01-28 09:00:00,47,11,59,47,0,0,59,23,246
2019-01-28 10:00:00,35,23,47,0,0,0,59,23,187
2019-01-28 11:00:00,35,23,23,11,0,35,23,35,185
2019-01-28 12:00:00,59,35,35,23,0,0,47,35,234
2019-01-28 13:00:00,47,23,47,0,23,0,23,23,186
2019-01-28 14:00:00,212,11,35,0,59,11,118,82,528
2019-01-28 15:00:00,94,47,70,11,11,0,94,23,350
2019-01-28 16:00:00,82,35,0,23,23,0,106,11,280
2019-01-28 17:00:00,70,11,0,0,11,0,94,0,186
2019-01-28 18:00:00,23,11,0,0,11,0,70,11,126
2019-01-28 19:00:00,11,0,0,0,0,0,47,0,58
2019-01-28 20:00:00,23,23,0,0,0,0,47,0,93
2019-01-28 21:00:00,11,11,0,0,0,0,106,11,139
2019-01-28 22:00:00,0,0,0,0,0,0,11,0,11
2019-01-28 23:00:00,0,0,0,0,11,0,0,0,11
2019-01-29 00:00:00,0,0,0,0,11,0,0,0,11
2019-01-29 01:00:00,11,0,0,0,11,0,0,0,22
2019-01-29 02:00:00,0,0,0,0,0,0,0,0,0
2019-01-29 03:00:00,11,0,0,0,0,0,11,0,22
2019-01-29 04:00:00,0,0,0,0,0,0,0,0,0
2019-01-29 05:00:00,0,0,0,0,0,0,11,0,11
2019-01-29 06:00:00,11,0,11,11,0,0,11,23,67
2019-01-29 07:00:00,94,11,0,23,0,11,82,11,232
2019-01-29 08:00:00,106,11,59,0,0,23,70,70,339
2019-01-29 09:00:00,35,0,23,0,0,11,23,11,103
2019-01-29 10:00:00,35,82,47,0,11,0,23,0,198
2019-01-29 11:00:00,106,35,70,23,35,35,94,23,421
2019-01-29 12:00:00,129,35,59,35,23,47,59,70,457
2019-01-29 13:00:00,118,35,35,0,11,23,94,35,351
2019-01-29 14:00:00,129,35,47,23,11,0,70,47,362
2019-01-29 15:00:00,94,47,70,11,11,23,47,11,314
2019-01-29 16:00:00,118,47,0,23,23,11,106,47,375
2019-01-29 17:00:00,47,59,11,0,35,0,59,35,246
2019-01-29 18:00:00,35,70,23,23,23,11,47,11,243
2019-01-29 19:00:00,11,11,0,11,35,23,82,0,173
2019-01-29 20:00:00,23,23,0,0,11,11,70,0,138
2019-01-29 21:00:00,35,0,0,11,11,0,59,11,127
2019-01-29 22:00:00,0,0,0,0,0,11,59,0,70
2019-01-29 23:00:00,0,0,0,0,0,0,47,0,47
2019-01-30 00:00:00,0,0,0,0,0,11,0,0,11
2019-01-30 01:00:00,0,0,0,0,0,0,11,0,11
2019-01-30 02:00:00,0,11,0,0,0,0,0,0,11
2019-01-30 03:00:00,0,0,0,0,0,0,11,0,11
2019-01-30 04:00:00,0,0,0,0,0,0,0,0,0
2019-01-30 05:00:00,0,11,0,0,0,0,59,0,70
2019-01-30 06:00:00,70,0,0,11,0,0,47,0,128
2019-01-30 07:00:00,94,0,23,11,0,11,94,11,244
2019-01-30 08:00:00,11,11,35,11,11,0,35,129,243
2019-01-30 09:00:00,94,47,11,0,0,0,59,23,234
2019-01-30 10:00:00,70,23,35,0,0,23,47,23,221
2019-01-30 11:00:00,35,47,47,0,11,0,106,23,269
2019-01-30 12:00:00,236,11,23,0,0,11,153,0,434
2019-01-30 13:00:00,153,23,23,0,35,11,118,11,374
2019-01-30 14:00:00,342,47,35,0,35,23,153,59,694
2019-01-30 15:00:00,94,35,47,0,23,0,118,0,317
2019-01-30 16:00:00,47,47,11,0,11,0,82,11,209
2019-01-30 17:00:00,23,23,11,0,0,0,94,47,198
2019-01-30 18:00:00,11,23,0,11,0,23,59,11,138
2019-01-30 19:00:00,47,0,0,0,0,11,59,0,117
2019-01-30 20:00:00,11,11,23,23,0,0,23,11,102
2019-01-30 21:00:00,0,0,0,0,0,0,0,0,0
2019-01-30 22:00:00,0,0,0,0,0,0,0,0,0
2019-01-30 23:00:00,0,0,0,0,0,0,0,0,0
2019-01-31 00:00:00,0,0,0,0,0,0,0,0,0
2019-01-31 01:00:00,0,0,0,0,0,0,11,0,11
2019-01-31 02:00:00,0,0,0,0,0,0,0,0,0
2019-01-31 03:00:00,0,0,0,0,0,0,0,11,11
2019-01-31 04:00:00,0,0,0,0,0,0,11,0,11
2019-01-31 05:00:00,35,0,0,0,0,0,23,11,69
2019-01-31 06:00:00,35,35,11,0,0,11,35,0,127
2019-01-31 07:00:00,82,0,35,11,0,11,23,0,162
2019-01-31 08:00:00,118,23,59,11,11,11,35,35,303
2019-01-31 09:00:00,177,0,70,0,11,11,23,11,303
2019-01-31 10:00:00,82,11,35,11,47,11,23,23,243
2019-01-31 11:00:00,47,82,82,0,47,11,94,0,363
2019-01-31 12:00:00,106,70,82,47,0,11,106,35,457
2019-01-31 13:00:00,118,82,118,59,35,35,129,23,599
2019-01-31 14:00:00,188,23,23,47,11,35,94,59,480
2019-01-31 15:00:00,94,23,47,0,11,23,82,23,303
2019-01-31 16:00:00,82,23,0,23,11,70,59,23,291
2019-01-31 17:00:00,47,23,0,0,11,11,70,0,162
2019-01-31 18:00:00,35,365,0,35,23,35,59,11,563
2019-01-31 19:00:00,47,70,11,0,0,0,0,11,139
2019-01-31 20:00:00,11,295,0,0,0,0,35,0,341
2019-01-31 21:00:00,23,0,0,11,0,11,0,11,56
2019-01-31 22:00:00,23,0,0,0,0,0,0,0,23
2019-01-31 23:00:00,0,0,0,11,0,0,0,0,11
2019-02-01 00:00:00,11,0,0,0,0,0,0,0,11
2019-02-01 01:00:00,11,0,0,23,0,0,0,0,34
2019-02-01 02:00:00,0,0,0,11,0,0,0,0,11
2019-02-01 03:00:00,11,0,0,0,0,0,23,0,34
2019-02-01 04:00:00,11,0,0,11,0,0,47,0,69
2019-02-01 05:00:00,0,0,0,0,0,0,11,0,11
2019-02-01 06:00:00,11,0,0,11,11,0,35,0,68
2019-02-01 07:00:00,118,11,11,11,0,0,11,47,209
2019-02-01 08:00:00,47,35,11,0,11,35,47,94,280
2019-02-01 09:00:00,70,23,0,11,0,35,35,23,197
2019-02-01 10:00:00,70,11,0,11,0,0,129,11,232
2019-02-01 11:00:00,94,35,0,23,35,11,200,11,409
2019-02-01 12:00:00,165,23,11,11,11,11,82,47,361
2019-02-01 13:00:00,70,23,0,23,0,35,70,47,268
2019-02-01 14:00:00,106,70,0,11,11,23,153,70,444
2019-02-01 15:00:00,47,23,0,23,0,0,129,47,269
2019-02-01 16:00:00,0,11,0,11,0,0,47,11,80
2019-02-01 17:00:00,0,0,0,0,0,0,35,0,35
2019-02-01 18:00:00,0,0,0,0,0,23,11,0,34
2019-02-01 19:00:00,23,0,0,0,0,0,59,11,93
2019-02-01 20:00:00,11,35,0,35,11,47,0,11,150
2019-02-01 21:00:00,0,0,0,11,11,47,35,0,104
2019-02-01 22:00:00,23,0,0,35,0,177,35,0,270
2019-02-01 23:00:00,35,11,0,59,0,165,59,0,329
2019-02-02 00:00:00,59,11,0,23,0,23,23,0,139
2019-02-02 01:00:00,47,94,0,23,0,59,47,0,270
2019-02-02 02:00:00,23,0,0,0,0,0,11,0,34
2019-02-02 03:00:00,0,0,0,0,0,0,0,0,0
2019-02-02 04:00:00,0,0,0,0,0,0,23,0,23
2019-02-02 05:00:00,11,0,0,0,0,0,0,0,11
2019-02-02 06:00:00,0,0,0,0,0,0,11,0,11
2019-02-02 07:00:00,0,0,0,0,0,0,47,11,58
2019-02-02 08:00:00,23,0,0,0,0,0,94,0,117
2019-02-02 09:00:00,23,0,0,11,0,0,70,0,104
2019-02-02 10:00:00,35,11,0,0,0,11,70,35,162
2019-02-02 11:00:00,47,47,0,23,11,47,271,11,457
2019-02-02 12:00:00,82,47,0,59,23,35,129,23,398
2019-02-02 13:00:00,94,129,0,47,11,106,200,11,598
2019-02-02 14:00:00,94,106,0,47,11,129,365,11,763
2019-02-02 15:00:00,94,59,23,47,11,106,153,0,493
2019-02-02 16:00:00,47,82,0,11,0,35,165,11,351
2019-02-02 17:00:00,82,82,11,47,11,11,23,0,267
2019-02-02 18:00:00,23,59,0,23,0,11,129,23,268
2019-02-02 19:00:00,35,59,11,23,11,11,82,0,232
2019-02-02 20:00:00,23,23,0,11,11,35,47,0,150
2019-02-02 21:00:00,23,11,23,23,11,0,35,0,126
2019-02-02 22:00:00,0,11,0,0,0,0,47,0,58
2019-02-02 23:00:00,23,35,0,0,0,0,23,11,92
2019-02-03 00:00:00,11,0,0,0,0,11,47,11,80
2019-02-03 01:00:00,11,0,0,0,0,0,0,0,11
2019-02-03 02:00:00,11,0,0,0,0,0,23,0,34
2019-02-03 03:00:00,0,0,0,0,0,11,0,0,11
2019-02-03 04:00:00,0,0,0,0,0,0,0,0,0
2019-02-03 05:00:00,0,0,0,0,0,0,0,0,0
2019-02-03 06:00:00,0,0,0,0,0,0,0,0,0
2019-02-03 07:00:00,0,0,0,0,0,0,0,0,0
2019-02-03 08:00:00,0,0,0,0,0,0,0,11,11
2019-02-03 09:00:00,11,23,0,0,11,0,23,0,68
2019-02-03 10:00:00,35,11,0,23,23,0,47,0,139
2019-02-03 11:00:00,23,59,0,47,23,47,177,35,411
2019-02-03 12:00:00,106,188,0,47,35,59,295,23,753
2019-02-03 13:00:00,94,153,23,70,94,94,259,0,787
2019-02-03 14:00:00,94,106,0,82,106,106,306,35,835
2019-02-03 15:00:00,106,141,23,59,11,129,224,35,728
2019-02-03 16:00:00,70,94,0,11,23,70,94,11,373
2019-02-03 17:00:00,94,35,0,11,11,35,94,23,303
2019-02-03 18:00:00,35,11,0,11,35,23,23,23,161
2019-02-03 19:00:00,59,23,0,0,0,0,11,11,104
2019-02-03 20:00:00,11,11,11,0,23,23,23,0,102
2019-02-03 21:00:00,0,0,0,0,0,0,0,0,0
2019-02-03 22:00:00,0,0,0,0,0,0,0,0,0
2019-02-03 23:00:00,0,0,0,0,0,0,0,0,0
2019-02-04 00:00:00,0,0,0,0,0,0,11,0,11
2019-02-04 01:00:00,0,11,0,0,0,0,35,0,46
2019-02-04 02:00:00,0,0,11,0,0,0,11,0,22
2019-02-04 03:00:00,0,0,0,0,0,0,23,0,23
2019-02-04 04:00:00,0,0,0,0,0,0,0,0,0
2019-02-04 05:00:00,11,0,0,0,0,0,0,11,22
2019-02-04 06:00:00,11,0,0,11,0,0,35,0,57
2019-02-04 07:00:00,94,11,0,11,0,11,59,35,221
2019-02-04 08:00:00,82,23,11,0,0,0,23,70,209
2019-02-04 09:00:00,35,23,23,0,0,23,59,23,186
2019-02-04 10:00:00,59,23,35,0,11,23,94,11,256
2019-02-04 11:00:00,47,47,47,11,11,0,70,23,256
2019-02-04 12:00:00,141,47,82,11,23,23,59,94,480
2019-02-04 13:00:00,129,35,59,35,23,11,47,47,386
2019-02-04 14:00:00,129,11,23,0,0,11,82,82,338
2019-02-04 15:00:00,141,23,35,0,11,11,94,0,315
2019-02-04 16:00:00,70,11,0,23,0,11,35,0,150
2019-02-04 17:00:00,23,23,0,0,11,0,23,0,80
2019-02-04 18:00:00,11,23,0,11,0,11,11,0,67
2019-02-04 19:00:00,11,23,0,11,0,0,35,0,80
2019-02-04 20:00:00,11,11,0,0,0,0,23,0,45
2019-02-04 21:00:00,0,23,0,0,0,0,23,0,46
2019-02-04 22:00:00,0,23,0,0,0,0,0,11,34
2019-02-04 23:00:00,0,23,0,0,0,0,11,0,34
2019-02-05 00:00:00,0,11,0,0,11,0,0,11,33
2019-02-05 01:00:00,0,11,0,0,0,0,0,11,22
2019-02-05 02:00:00,0,0,0,0,0,0,23,0,23
2019-02-05 03:00:00,0,0,0,0,0,0,0,0,0
2019-02-05 04:00:00,0,0,0,0,0,0,0,0,0
2019-02-05 05:00:00,0,0,0,11,0,0,11,0,22
2019-02-05 06:00:00,23,23,0,11,35,11,0,11,114
2019-02-05 07:00:00,59,35,0,11,0,0,11,23,139
2019-02-05 08:00:00,59,23,70,0,0,0,35,94,281
2019-02-05 09:00:00,23,11,59,11,0,11,23,35,173
2019-02-05 10:00:00,82,59,59,11,23,11,106,0,351
2019-02-05 11:00:00,82,59,47,23,0,11,153,11,386
2019-02-05 12:00:00,177,35,35,70,11,94,165,82,669
2019-02-05 13:00:00,106,23,35,11,0,11,70,35,291
2019-02-05 14:00:00,200,47,35,0,0,11,106,59,458
2019-02-05 15:00:00,153,47,35,23,0,35,35,35,363
2019-02-05 16:00:00,129,59,0,0,0,11,59,70,328
2019-02-05 17:00:00,0,0,70,0,11,23,35,11,150
2019-02-05 18:00:00,35,47,23,35,23,0,23,0,186
2019-02-05 19:00:00,59,23,11,0,11,35,23,11,173
2019-02-05 20:00:00,0,11,23,0,0,11,0,0,45
2019-02-05 21:00:00,35,0,0,23,23,11,11,11,114
2019-02-05 22:00:00,23,11,0,0,0,0,11,0,45
2019-02-05 23:00:00,11,0,0,0,0,0,0,0,11
2019-02-06 00:00:00,0,0,0,0,0,0,11,0,11
2019-02-06 01:00:00,11,11,0,11,0,0,0,0,33
2019-02-06 02:00:00,0,0,0,0,0,0,0,0,0
2019-02-06 03:00:00,0,0,0,0,0,0,11,0,11
2019-02-06 04:00:00,0,0,0,0,0,0,11,0,11
2019-02-06 05:00:00,35,0,0,0,0,0,0,11,46
2019-02-06 06:00:00,11,0,0,23,0,0,35,0,69
2019-02-06 07:00:00,106,23,0,23,11,11,47,23,244
2019-02-06 08:00:00,82,23,47,11,0,0,82,47,292
2019-02-06 09:00:00,47,0,59,0,0,11,82,11,210
2019-02-06 10:00:00,129,23,82,0,0,23,129,47,433
2019-02-06 11:00:00,82,59,70,70,11,35,118,47,492
2019-02-06 12:00:00,82,35,35,23,0,11,153,23,362
2019-02-06 13:00:00,165,35,23,82,23,0,94,70,492
2019-02-06 14:00:00,129,11,23,23,0,0,82,47,315
2019-02-06 15:00:00,59,23,23,23,0,47,47,0,222
2019-02-06 16:00:00,70,11,11,11,0,23,82,23,231
2019-02-06 17:00:00,47,0,0,35,0,47,11,11,151
2019-02-06 18:00:00,35,11,0,23,0,23,11,47,150
2019-02-06 19:00:00,11,0,0,35,0,0,0,23,69
2019-02-06 20:00:00,23,35,0,11,11,47,11,0,138
2019-02-06 21:00:00,35,0,0,11,0,23,35,0,104
2019-02-06 22:00:00,0,0,0,11,0,0,118,0,129
2019-02-06 23:00:00,0,0,0,0,0,0,59,0,59
2019-02-07 00:00:00,11,0,0,0,0,0,35,0,46
2019-02-07 01:00:00,0,0,0,11,0,0,35,0,46
2019-02-07 02:00:00,0,0,0,0,0,0,23,0,23
2019-02-07 03:00:00,0,0,0,0,0,11,35,0,46
2019-02-07 04:00:00,0,0,0,11,0,0,35,0,46
2019-02-07 05:00:00,11,0,0,0,0,0,47,0,58
2019-02-07 06:00:00,23,0,0,0,0,0,47,0,70
2019-02-07 07:00:00,59,0,0,35,0,0,35,11,140
2019-02-07 08:00:00,82,11,23,0,0,11,35,70,232
2019-02-07 09:00:00,70,23,23,11,11,35,59,11,243
2019-02-07 10:00:00,47,118,11,23,11,11,59,35,315
2019-02-07 11:00:00,11,35,35,11,23,0,47,11,173
2019-02-07 12:00:00,59,35,23,118,23,47,118,23,446
2019-02-07 13:00:00,47,47,70,59,35,11,59,11,339
2019-02-07 14:00:00,141,47,11,35,129,35,177,70,645
2019-02-07 15:00:00,106,47,47,35,59,47,70,47,458
2019-02-07 16:00:00,23,106,11,11,11,23,35,23,243
2019-02-07 17:00:00,35,0,0,11,0,11,82,0,139
2019-02-07 18:00:00,35,47,0,11,11,59,94,0,257
2019-02-07 19:00:00,11,11,0,0,11,23,23,0,79
2019-02-07 20:00:00,11,11,0,11,11,47,47,0,138
2019-02-07 21:00:00,23,11,0,11,23,0,47,11,126
2019-02-07 22:00:00,11,0,0,11,0,0,35,0,57
2019-02-07 23:00:00,0,0,0,11,0,0,35,0,46
2019-02-08 00:00:00,94,0,0,0,0,0,0,0,94
2019-02-08 01:00:00,59,0,0,0,0,0,11,0,70
2019-02-08 02:00:00,0,0,0,0,0,0,11,0,11
2019-02-08 03:00:00,0,0,0,0,0,0,23,0,23
2019-02-08 04:00:00,0,0,0,0,0,0,11,0,11
2019-02-08 05:00:00,0,0,0,0,0,0,23,0,23
2019-02-08 06:00:00,35,0,0,23,0,0,35,0,93
2019-02-08 07:00:00,59,0,0,23,0,0,59,23,164
2019-02-08 08:00:00,129,11,23,23,0,0,47,118,351
2019-02-08 09:00:00,47,23,0,0,0,0,35,35,140
2019-02-08 10:00:00,35,47,11,23,23,0,106,82,327
2019-02-08 11:00:00,70,70,11,35,11,11,35,47,290
2019-02-08 12:00:00,82,23,35,35,11,23,70,82,361
2019-02-08 13:00:00,106,47,23,47,0,23,70,82,398
2019-02-08 14:00:00,129,47,11,47,11,70,47,82,444
2019-02-08 15:00:00,141,35,35,23,11,11,165,23,444
2019-02-08 16:00:00,70,11,0,0,11,23,23,35,173
2019-02-08 17:00:00,59,0,0,0,0,11,23,0,93
2019-02-08 18:00:00,23,0,0,11,11,23,11,11,90
2019-02-08 19:00:00,23,11,0,11,0,0,11,0,56
2019-02-08 20:00:00,11,0,0,0,0,23,11,0,45
2019-02-08 21:00:00,0,0,0,23,0,0,0,0,23
2019-02-08 22:00:00,11,0,0,0,0,0,35,0,46
2019-02-08 23:00:00,23,0,0,0,0,0,47,0,70
2019-02-09 00:00:00,11,0,0,23,11,11,11,11,78
2019-02-09 01:00:00,0,0,0,0,0,0,0,0,0
2019-02-09 02:00:00,0,0,0,0,0,0,11,0,11
2019-02-09 03:00:00,0,0,0,0,0,0,0,0,0
2019-02-09 04:00:00,0,0,0,0,0,0,23,0,23
2019-02-09 05:00:00,0,0,0,0,0,0,23,0,23
2019-02-09 06:00:00,0,0,0,0,0,0,11,0,11
2019-02-09 07:00:00,0,11,0,0,0,0,11,0,22
2019-02-09 08:00:00,11,0,0,0,0,0,35,0,46
2019-02-09 09:00:00,11,35,0,11,0,0,59,0,116
2019-02-09 10:00:00,23,23,11,0,0,0,35,11,103
2019-02-09 11:00:00,35,11,0,0,23,35,59,11,174
2019-02-09 12:00:00,11,59,0,11,0,59,106,0,246
2019-02-09 13:00:00,23,70,0,0,0,23,165,0,281
2019-02-09 14:00:00,118,94,0,23,0,59,82,23,399
2019-02-09 15:00:00,94,11,0,0,11,47,94,23,280
2019-02-09 16:00:00,70,59,0,0,0,35,94,0,258
2019-02-09 17:00:00,23,59,0,11,0,0,59,11,163
2019-02-09 18:00:00,0,11,0,0,0,11,47,0,69
2019-02-09 19:00:00,11,35,0,0,0,11,59,0,116
2019-02-09 20:00:00,0,35,0,23,0,0,35,0,93
2019-02-09 21:00:00,11,0,0,23,0,0,35,0,69
2019-02-09 22:00:00,23,0,0,11,0,0,94,11,139
2019-02-09 23:00:00,0,0,0,0,0,0,23,11,34
2019-02-10 00:00:00,165,0,0,47,0,0,23,0,235
2019-02-10 01:00:00,0,0,0,0,0,23,35,0,58
2019-02-10 02:00:00,23,0,0,0,0,0,11,11,45
2019-02-10 03:00:00,11,11,0,0,0,0,0,11,33
2019-02-10 04:00:00,0,11,0,0,0,0,11,0,22
2019-02-10 05:00:00,0,11,0,0,0,0,11,0,22
2019-02-10 06:00:00,0,23,0,0,0,0,11,0,34
2019-02-10 07:00:00,23,11,0,11,0,0,0,0,45
2019-02-10 08:00:00,0,23,0,0,0,0,35,0,58
2019-02-10 09:00:00,23,23,0,11,0,0,59,0,116
2019-02-10 10:00:00,47,47,0,0,11,0,94,11,210
2019-02-10 11:00:00,82,0,0,35,11,59,47,23,257
2019-02-10 12:00:00,118,47,11,11,11,35,354,35,622
2019-02-10 13:00:00,236,188,0,35,23,59,247,0,788
2019-02-10 14:00:00,118,129,11,11,11,59,271,11,621
2019-02-10 15:00:00,94,70,23,11,0,94,200,23,515
2019-02-10 16:00:00,47,82,11,23,11,0,106,11,291
2019-02-10 17:00:00,23,47,11,0,0,35,47,23,186
2019-02-10 18:00:00,23,47,0,35,0,0,11,0,116
2019-02-10 19:00:00,0,35,0,11,11,11,59,0,127
2019-02-10 20:00:00,70,23,0,0,0,23,11,0,127
2019-02-10 21:00:00,11,0,0,11,0,0,11,0,33
2019-02-10 22:00:00,11,0,0,0,0,0,0,11,22
2019-02-10 23:00:00,11,0,0,0,0,0,0,0,11
2019-02-11 00:00:00,0,0,0,0,0,0,11,0,11
2019-02-11 01:00:00,0,0,0,0,0,0,11,0,11
2019-02-11 02:00:00,0,0,0,0,0,0,11,0,11
2019-02-11 03:00:00,0,0,0,0,0,0,0,0,0
2019-02-11 04:00:00,0,0,0,0,0,0,0,0,0
2019-02-11 05:00:00,23,0,0,0,0,0,11,0,34
2019-02-11 06:00:00,23,0,0,0,0,0,23,0,46
2019-02-11 07:00:00,47,11,0,11,0,0,35,23,127
2019-02-11 08:00:00,94,23,23,0,0,23,35,188,386
2019-02-11 09:00:00,47,47,59,0,0,11,11,35,210
2019-02-11 10:00:00,106,35,70,23,11,23,35,47,350
2019-02-11 11:00:00,35,35,23,0,11,11,141,59,315
2019-02-11 12:00:00,106,82,23,11,11,35,165,59,492
2019-02-11 13:00:00,23,94,59,23,23,47,129,70,468
2019-02-11 14:00:00,0,47,59,23,23,35,129,59,375
2019-02-11 15:00:00,0,70,23,11,0,0,94,70,268
2019-02-11 16:00:00,0,47,11,11,0,11,47,11,138
2019-02-11 17:00:00,0,94,0,11,23,23,35,0,186
2019-02-11 18:00:00,0,0,0,0,0,0,0,11,11
2019-02-11 19:00:00,0,0,0,0,0,0,47,35,82
2019-02-11 20:00:00,0,23,0,11,0,0,11,11,56
2019-02-11 21:00:00,0,23,11,11,11,11,11,11,89
2019-02-11 22:00:00,0,23,0,0,0,11,0,0,34
2019-02-11 23:00:00,0,11,0,0,23,0,0,0,34
2019-02-12 00:00:00,0,0,0,0,0,0,0,0,0
2019-02-12 01:00:00,0,0,0,0,0,0,0,11,11
2019-02-12 02:00:00,0,0,0,0,0,0,0,0,0
2019-02-12 03:00:00,0,0,0,0,0,0,0,0,0
2019-02-12 04:00:00,0,0,0,0,0,0,11,0,11
2019-02-12 05:00:00,11,11,0,0,0,0,11,0,33
2019-02-12 06:00:00,23,0,0,0,0,0,0,0,23
2019-02-12 07:00:00,70,11,11,11,11,0,23,35,172
2019-02-12 08:00:00,141,11,35,0,11,11,59,59,327
2019-02-12 09:00:00,70,11,70,0,11,23,23,23,231
2019-02-12 10:00:00,94,11,35,0,0,0,94,47,281
2019-02-12 11:00:00,106,23,23,0,0,11,35,59,257
2019-02-12 12:00:00,94,70,23,0,11,11,118,47,374
2019-02-12 13:00:00,47,35,11,11,0,47,59,47,257
2019-02-12 14:00:00,188,70,23,35,35,23,165,70,609
2019-02-12 15:00:00,106,47,59,11,0,11,82,35,351
2019-02-12 16:00:00,82,11,11,11,0,0,59,11,185
2019-02-12 17:00:00,0,35,11,11,0,11,35,0,103
2019-02-12 18:00:00,11,35,35,11,0,11,47,11,161
2019-02-12 19:00:00,11,11,0,11,0,0,35,0,68
2019-02-12 20:00:00,0,11,11,11,0,11,35,0,79
2019-02-12 21:00:00,0,0,0,0,0,0,11,0,11
2019-02-12 22:00:00,23,0,11,0,0,11,47,0,92
2019-02-12 23:00:00,11,0,0,0,0,23,23,0,57
2019-02-13 00:00:00,0,0,23,0,0,0,23,11,57
2019-02-13 01:00:00,0,0,23,0,0,0,11,0,34
2019-02-13 02:00:00,0,0,23,0,0,0,0,0,23
2019-02-13 03:00:00,11,0,35,0,0,0,11,0,57
2019-02-13 04:00:00,0,0,23,0,0,0,0,0,23
2019-02-13 05:00:00,23,0,23,0,0,0,0,11,57
2019-02-13 06:00:00,35,11,23,0,0,0,35,11,115
2019-02-13 07:00:00,47,35,35,23,0,0,59,23,222
2019-02-13 08:00:00,94,23,23,0,0,11,11,47,209
2019-02-13 09:00:00,59,23,23,0,11,0,11,0,127
2019-02-13 10:00:00,47,11,11,0,23,11,11,35,149
2019-02-13 11:00:00,94,11,11,11,47,141,82,59,456
2019-02-13 12:00:00,129,153,23,11,47,59,165,47,634
2019-02-13 13:00:00,118,141,11,23,23,23,188,59,586
2019-02-13 14:00:00,224,106,11,70,11,23,129,59,633
2019-02-13 15:00:00,94,35,11,11,11,35,129,23,349
2019-02-13 16:00:00,129,23,0,0,11,0,94,35,292
2019-02-13 17:00:00,70,47,0,11,0,23,23,11,185
2019-02-13 18:00:00,23,94,0,11,23,35,11,11,208
2019-02-13 19:00:00,47,47,0,0,0,11,94,23,222
2019-02-13 20:00:00,23,35,0,0,23,23,70,11,185
2019-02-13 21:00:00,23,59,0,0,35,11,23,0,151
2019-02-13 22:00:00,35,23,0,0,11,11,23,0,103
2019-02-13 23:00:00,11,23,0,0,11,0,0,0,45
2019-02-14 00:00:00,0,0,0,0,0,0,0,0,0
2019-02-14 01:00:00,0,0,0,0,0,0,0,0,0
2019-02-14 02:00:00,0,11,0,0,0,0,11,11,33
2019-02-14 03:00:00,0,0,0,0,0,0,23,0,23
2019-02-14 04:00:00,0,0,0,0,0,0,0,0,0
2019-02-14 05:00:00,0,0,0,0,0,0,11,11,22
2019-02-14 06:00:00,23,0,0,0,0,0,11,0,34
2019-02-14 07:00:00,47,0,11,0,0,11,11,23,103
2019-02-14 08:00:00,106,23,47,11,23,0,82,106,398
2019-02-14 09:00:00,70,23,23,23,23,0,47,11,220
2019-02-14 10:00:00,70,0,47,11,11,11,23,0,173
2019-02-14 11:00:00,82,47,23,11,23,23,47,0,256
2019-02-14 12:00:00,259,59,23,59,23,11,70,47,551
2019-02-14 13:00:00,94,11,59,0,0,23,153,23,363
2019-02-14 14:00:00,177,129,47,0,47,23,188,94,705
2019-02-14 15:00:00,200,82,94,35,11,47,106,47,622
2019-02-14 16:00:00,94,11,0,70,23,47,106,23,374
2019-02-14 17:00:00,70,47,11,0,11,23,70,11,243
2019-02-14 18:00:00,59,23,0,70,23,47,82,35,339
2019-02-14 19:00:00,70,0,0,23,11,23,47,47,221
2019-02-14 20:00:00,0,11,11,11,0,0,11,0,44
2019-02-14 21:00:00,59,23,0,0,11,47,35,11,186
2019-02-14 22:00:00,11,0,0,0,11,11,35,0,68
2019-02-14 23:00:00,0,0,0,0,0,35,23,0,58
2019-02-15 00:00:00,0,0,0,11,11,0,0,0,22
2019-02-15 01:00:00,0,0,0,11,0,0,0,0,11
2019-02-15 02:00:00,0,0,11,11,0,0,23,0,45
2019-02-15 03:00:00,11,0,0,0,0,0,35,0,46
2019-02-15 04:00:00,11,0,0,0,0,0,23,0,34
2019-02-15 05:00:00,35,0,0,0,0,0,23,23,81
2019-02-15 06:00:00,0,0,0,0,0,0,23,0,23
2019-02-15 07:00:00,70,11,11,23,0,11,59,23,208
2019-02-15 08:00:00,118,0,23,11,11,11,35,70,279
2019-02-15 09:00:00,47,23,23,35,11,11,70,35,255
2019-02-15 10:00:00,35,23,23,23,35,0,70,35,244
2019-02-15 11:00:00,82,35,11,0,11,11,59,47,256
2019-02-15 12:00:00,141,11,11,0,11,59,82,35,350
2019-02-15 13:00:00,94,35,0,35,11,23,165,23,386
2019-02-15 14:00:00,259,35,11,23,11,11,212,47,609
2019-02-15 15:00:00,200,11,11,11,0,35,82,35,385
2019-02-15 16:00:00,129,0,11,11,11,47,106,0,315
2019-02-15 17:00:00,35,11,11,0,0,11,59,0,127
2019-02-15 18:00:00,35,23,0,0,0,35,11,0,104
2019-02-15 19:00:00,35,11,0,11,0,23,0,11,91
2019-02-15 20:00:00,23,11,0,23,0,11,23,0,91
2019-02-15 21:00:00,23,0,0,11,11,11,23,0,79
2019-02-15 22:00:00,0,0,0,0,0,11,35,0,46
2019-02-15 23:00:00,23,35,0,0,11,35,0,0,104
2019-02-16 00:00:00,11,0,0,0,0,35,35,11,92
2019-02-16 01:00:00,23,0,0,0,0,11,0,0,34
2019-02-16 02:00:00,0,23,0,0,11,11,11,0,56
2019-02-16 03:00:00,11,0,0,0,0,0,0,0,11
2019-02-16 04:00:00,0,0,0,0,0,0,0,0,0
2019-02-16 05:00:00,0,0,0,0,0,0,0,0,0
2019-02-16 06:00:00,0,0,0,0,0,0,0,0,0
2019-02-16 07:00:00,11,0,0,0,0,0,11,0,22
2019-02-16 08:00:00,11,11,0,0,0,0,23,0,45
2019-02-16 09:00:00,35,11,0,23,11,11,47,0,138
2019-02-16 10:00:00,82,35,0,23,11,35,35,23,244
2019-02-16 11:00:00,141,82,0,59,35,59,224,11,611
2019-02-16 12:00:00,177,224,11,70,59,236,283,11,1071
2019-02-16 13:00:00,118,153,11,47,35,106,436,35,941
2019-02-16 14:00:00,212,129,0,82,11,82,342,23,881
2019-02-16 15:00:00,188,35,0,70,0,59,153,23,528
2019-02-16 16:00:00,82,94,0,0,23,82,106,0,387
2019-02-16 17:00:00,82,35,23,0,23,11,106,0,280
2019-02-16 18:00:00,106,11,0,0,11,11,82,0,221
2019-02-16 19:00:00,11,0,11,0,0,11,47,0,80
2019-02-16 20:00:00,47,0,0,23,0,0,11,0,81
2019-02-16 21:00:00,82,11,0,0,0,11,59,11,174
2019-02-16 22:00:00,23,0,0,0,0,0,35,0,58
2019-02-16 23:00:00,23,0,11,0,0,0,23,11,68
2019-02-17 00:00:00,247,0,11,0,0,0,47,11,316
2019-02-17 01:00:00,118,0,0,0,0,11,23,0,152
2019-02-17 02:00:00,247,0,0,0,0,0,47,0,294
2019-02-17 03:00:00,59,0,0,0,0,0,35,0,94
2019-02-17 04:00:00,0,0,0,0,0,0,23,0,23
2019-02-17 05:00:00,0,0,0,0,0,0,35,0,35
2019-02-17 06:00:00,0,0,0,0,0,0,35,0,35
2019-02-17 07:00:00,0,0,0,0,0,0,11,0,11
2019-02-17 08:00:00,0,0,0,0,0,11,82,0,93
2019-02-17 09:00:00,23,11,0,0,11,0,59,0,104
2019-02-17 10:00:00,35,35,0,0,11,11,106,0,198
2019-02-17 11:00:00,70,59,0,47,47,23,165,11,422
2019-02-17 12:00:00,177,200,11,11,11,82,153,35,680
2019-02-17 13:00:00,106,436,0,82,23,129,472,59,1307
2019-02-17 14:00:00,153,224,0,59,47,94,472,35,1084
2019-02-17 15:00:00,118,70,11,35,23,82,306,11,656
2019-02-17 16:00:00,106,47,11,23,23,59,165,0,434
2019-02-17 17:00:00,35,23,0,23,0,0,118,0,199
2019-02-17 18:00:00,35,11,0,0,0,23,35,0,104
2019-02-17 19:00:00,11,23,11,35,0,0,23,0,103
2019-02-17 20:00:00,0,0,11,0,0,0,47,0,58
2019-02-17 21:00:00,0,11,0,0,0,0,11,11,33
2019-02-17 22:00:00,23,0,0,11,11,0,59,0,104
2019-02-17 23:00:00,0,0,0,0,0,0,11,0,11
2019-02-18 00:00:00,11,0,0,0,0,0,0,0,11
2019-02-18 01:00:00,0,0,0,0,0,0,11,0,11
2019-02-18 02:00:00,0,11,0,0,0,0,0,0,11
2019-02-18 03:00:00,0,0,0,0,0,0,23,0,23
2019-02-18 04:00:00,0,11,0,0,0,0,11,0,22
2019-02-18 05:00:00,0,0,0,0,0,0,23,0,23
2019-02-18 06:00:00,59,11,0,0,0,0,35,0,105
2019-02-18 07:00:00,47,0,0,0,0,0,23,35,105
2019-02-18 08:00:00,70,11,0,0,0,35,0,118,234
2019-02-18 09:00:00,177,11,23,0,0,0,59,0,270
2019-02-18 10:00:00,59,23,47,0,11,11,59,0,210
2019-02-18 11:00:00,47,82,35,47,11,23,82,11,338
2019-02-18 12:00:00,47,35,82,35,23,106,106,23,457
2019-02-18 13:00:00,106,94,82,23,0,0,283,59,647
2019-02-18 14:00:00,23,94,23,11,11,11,165,59,397
2019-02-18 15:00:00,129,23,70,23,11,23,82,23,384
2019-02-18 16:00:00,118,47,59,23,0,11,106,23,387
2019-02-18 17:00:00,82,0,35,0,0,23,59,11,210
2019-02-18 18:00:00,59,23,23,11,0,0,59,35,210
2019-02-18 19:00:00,35,11,11,11,0,11,11,0,90
2019-02-18 20:00:00,35,0,11,0,0,0,23,0,69
2019-02-18 21:00:00,0,11,11,0,0,11,23,11,67
2019-02-18 22:00:00,0,11,11,0,0,0,11,0,33
2019-02-18 23:00:00,23,0,0,0,0,0,0,0,23
2019-02-19 00:00:00,0,0,0,0,0,0,0,0,0
2019-02-19 01:00:00,11,0,0,0,0,0,11,0,22
2019-02-19 02:00:00,11,0,0,0,0,0,0,0,11
2019-02-19 03:00:00,0,0,0,0,0,0,0,0,0
2019-02-19 04:00:00,0,0,0,0,0,0,0,0,0
2019-02-19 05:00:00,70,0,0,0,0,0,23,11,104
2019-02-19 06:00:00,23,0,0,0,0,0,11,0,34
2019-02-19 07:00:00,47,0,11,0,0,0,35,35,128
2019-02-19 08:00:00,47,11,35,0,0,0,11,94,198
2019-02-19 09:00:00,23,11,11,0,23,0,59,11,138
2019-02-19 10:00:00,23,23,47,11,35,35,94,47,315
2019-02-19 11:00:00,188,47,11,11,47,11,188,47,550
2019-02-19 12:00:00,94,23,59,118,59,141,177,35,706
2019-02-19 13:00:00,70,23,23,70,11,59,660,35,951
2019-02-19 14:00:00,129,70,23,23,0,59,295,47,646
2019-02-19 15:00:00,94,35,23,59,35,47,165,35,493
2019-02-19 16:00:00,106,23,47,0,23,0,129,11,339
2019-02-19 17:00:00,94,0,11,0,0,59,106,11,281
2019-02-19 18:00:00,82,35,11,0,11,23,59,23,244
2019-02-19 19:00:00,23,35,94,23,11,59,47,11,303
2019-02-19 20:00:00,59,11,11,0,0,35,59,0,175
2019-02-19 21:00:00,11,0,0,0,0,0,94,0,105
2019-02-19 22:00:00,11,11,0,0,11,35,47,0,115
2019-02-19 23:00:00,23,0,0,11,0,0,0,0,34
2019-02-20 00:00:00,11,11,0,0,0,0,23,11,56
2019-02-20 01:00:00,0,0,0,0,0,0,0,0,0
2019-02-20 02:00:00,0,0,0,0,0,0,11,0,11
2019-02-20 03:00:00,0,0,0,0,0,0,0,0,0
2019-02-20 04:00:00,0,0,0,0,0,0,0,0,0
2019-02-20 05:00:00,0,11,0,0,0,0,0,11,22
2019-02-20 06:00:00,47,0,0,0,0,0,35,0,82
2019-02-20 07:00:00,59,11,11,11,0,11,23,47,173
2019-02-20 08:00:00,70,11,35,0,0,0,35,35,186
2019-02-20 09:00:00,94,59,11,11,11,11,11,47,255
2019-02-20 10:00:00,35,59,35,11,35,70,59,47,351
2019-02-20 11:00:00,118,94,47,35,11,94,153,35,587
2019-02-20 12:00:00,165,70,82,70,94,82,247,47,857
2019-02-20 13:00:00,200,82,35,70,47,70,259,165,928
2019-02-20 14:00:00,247,141,23,70,47,82,318,23,951
2019-02-20 15:00:00,129,106,23,47,47,94,165,47,658
2019-02-20 16:00:00,224,35,23,35,11,0,153,23,504
2019-02-20 17:00:00,106,35,47,11,35,35,106,0,375
2019-02-20 18:00:00,59,11,0,23,23,47,59,23,245
2019-02-20 19:00:00,47,23,0,0,0,35,23,0,128
2019-02-20 20:00:00,47,11,0,0,0,23,23,0,104
2019-02-20 21:00:00,0,0,0,11,0,0,11,11,33
2019-02-20 22:00:00,11,0,0,0,0,0,35,0,46
2019-02-20 23:00:00,0,0,0,0,0,0,0,0,0
2019-02-21 00:00:00,0,0,0,0,0,0,0,0,0
2019-02-21 01:00:00,0,0,0,0,0,0,0,0,0
2019-02-21 02:00:00,11,11,0,0,0,0,0,0,22
2019-02-21 03:00:00,0,0,0,0,0,0,11,11,22
2019-02-21 04:00:00,0,0,0,0,0,0,0,0,0
2019-02-21 05:00:00,11,0,0,0,0,0,0,0,11
2019-02-21 06:00:00,23,0,0,0,0,11,23,11,68
2019-02-21 07:00:00,47,11,11,0,0,11,35,11,126
2019-02-21 08:00:00,23,0,23,0,0,23,11,70,150
2019-02-21 09:00:00,35,35,23,0,11,11,47,47,209
2019-02-21 10:00:00,70,35,23,11,0,47,94,23,303
2019-02-21 11:00:00,106,11,35,70,0,11,35,70,338
2019-02-21 12:00:00,59,35,177,0,0,35,70,0,376
2019-02-21 13:00:00,188,47,70,0,11,35,129,94,574
2019-02-21 14:00:00,94,35,35,23,0,11,82,23,303
2019-02-21 15:00:00,82,23,47,11,11,0,129,23,326
2019-02-21 16:00:00,47,59,0,11,0,35,165,35,352
2019-02-21 17:00:00,11,11,0,11,0,23,82,0,138
2019-02-21 18:00:00,82,23,0,70,11,59,59,0,304
2019-02-21 19:00:00,23,11,0,11,23,23,35,0,126
2019-02-21 20:00:00,35,47,0,0,23,0,70,0,175
2019-02-21 21:00:00,35,0,0,11,0,0,11,0,57
2019-02-21 22:00:00,106,11,0,0,0,11,23,11,162
2019-02-21 23:00:00,0,0,0,0,0,0,11,0,11
2019-02-22 00:00:00,153,23,0,11,0,0,11,0,198
2019-02-22 01:00:00,11,0,0,0,0,0,0,0,11
2019-02-22 02:00:00,0,0,0,0,0,0,11,0,11
2019-02-22 03:00:00,0,0,0,0,0,0,11,0,11
2019-02-22 04:00:00,0,0,0,0,0,0,0,0,0
2019-02-22 05:00:00,0,0,0,0,0,0,11,0,11
2019-02-22 06:00:00,23,11,0,0,0,11,35,0,80
2019-02-22 07:00:00,11,0,0,0,0,0,23,47,81
2019-02-22 08:00:00,47,11,35,0,0,0,59,59,211
2019-02-22 09:00:00,47,23,23,0,0,0,59,23,175
2019-02-22 10:00:00,59,35,23,0,0,23,118,23,281
2019-02-22 11:00:00,188,70,0,35,0,23,118,23,457
2019-02-22 12:00:00,177,23,23,11,0,82,106,94,516
2019-02-22 13:00:00,153,118,11,0,35,11,224,11,563
2019-02-22 14:00:00,141,94,23,47,35,35,200,35,610
2019-02-22 15:00:00,177,59,35,11,23,11,141,35,492
2019-02-22 16:00:00,47,23,11,0,23,11,82,0,197
2019-02-22 17:00:00,59,23,0,0,0,0,35,11,128
2019-02-22 18:00:00,94,35,0,11,11,11,59,0,221
2019-02-22 19:00:00,70,0,0,0,0,0,47,0,117
2019-02-22 20:00:00,35,0,11,0,0,11,23,11,91
2019-02-22 21:00:00,11,0,0,0,0,0,35,0,46
2019-02-22 22:00:00,23,35,0,0,11,59,94,0,222
2019-02-22 23:00:00,35,0,0,0,0,11,23,11,80
2019-02-23 00:00:00,0,0,0,0,0,0,11,11,22
2019-02-23 01:00:00,23,0,0,0,0,0,0,0,23
2019-02-23 02:00:00,0,0,0,0,0,0,0,11,11
2019-02-23 03:00:00,0,0,0,0,0,0,0,0,0
2019-02-23 04:00:00,0,0,0,0,0,0,0,0,0
2019-02-23 05:00:00,0,0,0,0,0,0,0,11,11
2019-02-23 06:00:00,0,0,0,0,0,0,11,0,11
2019-02-23 07:00:00,35,0,0,0,0,0,35,11,81
2019-02-23 08:00:00,47,47,11,0,0,0,47,0,152
2019-02-23 09:00:00,23,11,23,0,0,0,59,11,127
2019-02-23 10:00:00,106,342,11,35,0,11,70,0,575
2019-02-23 11:00:00,82,59,0,11,11,35,318,47,563
2019-02-23 12:00:00,177,236,35,23,23,59,354,35,942
2019-02-23 13:00:00,188,70,0,47,23,118,354,47,847
2019-02-23 14:00:00,129,59,11,11,11,82,224,0,527
2019-02-23 15:00:00,129,35,11,23,11,35,247,35,526
2019-02-23 16:00:00,106,483,11,23,0,94,70,0,787
2019-02-23 17:00:00,106,35,11,0,11,35,23,35,256
2019-02-23 18:00:00,23,11,0,0,0,11,23,23,91
2019-02-23 19:00:00,23,11,0,0,11,11,23,70,149
2019-02-23 20:00:00,0,11,0,0,11,11,11,0,44
2019-02-23 21:00:00,11,0,0,0,0,0,35,0,46
2019-02-23 22:00:00,23,0,0,0,0,0,35,11,69
2019-02-23 23:00:00,11,0,0,0,0,0,0,11,22
2019-02-24 00:00:00,0,11,0,0,0,0,0,0,11
2019-02-24 01:00:00,0,23,0,11,0,0,0,0,34
2019-02-24 02:00:00,0,0,0,0,0,0,0,0,0
2019-02-24 03:00:00,0,0,0,11,0,11,23,0,45
2019-02-24 04:00:00,0,0,0,0,0,0,0,0,0
2019-02-24 05:00:00,0,0,0,0,0,0,23,0,23
2019-02-24 06:00:00,0,0,0,0,0,0,0,0,0
2019-02-24 07:00:00,0,0,0,0,0,0,11,0,11
2019-02-24 08:00:00,0,0,0,0,0,0,23,23,46
2019-02-24 09:00:00,35,23,0,0,0,0,35,11,104
2019-02-24 10:00:00,0,11,0,0,0,0,59,0,70
2019-02-24 11:00:00,70,35,23,11,23,59,47,59,327
2019-02-24 12:00:00,188,106,94,23,35,165,318,23,952
2019-02-24 13:00:00,295,236,82,153,94,177,637,59,1733
2019-02-24 14:00:00,271,236,23,129,129,389,767,47,1991
2019-02-24 15:00:00,271,165,11,47,94,200,413,11,1212
2019-02-24 16:00:00,495,82,0,35,59,82,200,70,1023
2019-02-24 17:00:00,259,70,0,11,59,35,141,23,598
2019-02-24 18:00:00,23,35,0,11,0,11,47,11,138
2019-02-24 19:00:00,0,0,0,23,0,23,11,0,57
2019-02-24 20:00:00,23,0,0,0,11,0,0,11,45
2019-02-24 21:00:00,23,0,0,0,0,0,11,0,34
2019-02-24 22:00:00,11,0,0,11,0,0,11,0,33
2019-02-24 23:00:00,11,0,0,0,0,0,0,0,11
2019-02-25 00:00:00,0,11,0,0,0,0,11,0,22
2019-02-25 01:00:00,0,0,23,0,0,0,11,0,34
2019-02-25 02:00:00,11,0,0,0,0,0,11,0,22
2019-02-25 03:00:00,0,0,0,0,0,0,0,0,0
2019-02-25 04:00:00,0,0,0,0,0,0,0,0,0
2019-02-25 05:00:00,11,0,0,0,0,0,11,0,22
2019-02-25 06:00:00,47,0,0,0,0,0,23,11,81
2019-02-25 07:00:00,70,0,0,11,0,11,47,70,209
2019-02-25 08:00:00,59,35,23,11,23,11,82,47,291
2019-02-25 09:00:00,35,35,59,0,0,0,35,23,187
2019-02-25 10:00:00,82,59,35,0,11,23,23,59,292
2019-02-25 11:00:00,94,59,23,11,0,11,94,47,339
2019-02-25 12:00:00,129,59,70,35,0,0,94,47,434
2019-02-25 13:00:00,106,70,70,11,11,23,106,23,420
2019-02-25 14:00:00,200,47,47,0,0,11,106,153,564
2019-02-25 15:00:00,153,59,11,11,11,35,59,11,350
2019-02-25 16:00:00,106,141,11,23,0,35,59,59,434
2019-02-25 17:00:00,70,35,11,11,0,11,82,11,231
2019-02-25 18:00:00,59,47,0,11,11,23,59,0,210
2019-02-25 19:00:00,11,0,0,0,0,0,11,0,22
2019-02-25 20:00:00,0,0,0,0,11,0,11,0,22
2019-02-25 21:00:00,0,0,0,0,0,0,23,0,23
2019-02-25 22:00:00,11,0,0,0,0,0,0,0,11
2019-02-25 23:00:00,35,0,0,0,0,0,11,0,46
2019-02-26 00:00:00,11,11,11,0,0,0,11,0,44
2019-02-26 01:00:00,11,0,0,0,0,0,0,0,11
2019-02-26 02:00:00,0,0,0,0,0,0,11,0,11
2019-02-26 03:00:00,0,0,11,0,0,0,0,0,11
2019-02-26 04:00:00,0,0,11,0,0,0,0,0,11
2019-02-26 05:00:00,70,0,11,0,0,0,11,0,92
2019-02-26 06:00:00,35,11,11,0,0,0,35,0,92
2019-02-26 07:00:00,94,11,11,11,11,23,47,11,219
2019-02-26 08:00:00,165,0,70,11,11,35,70,94,456
2019-02-26 09:00:00,23,82,35,11,0,11,23,23,208
2019-02-26 10:00:00,82,236,23,11,0,59,70,11,492
2019-02-26 11:00:00,82,153,23,35,23,70,70,23,479
2019-02-26 12:00:00,153,94,70,70,23,35,224,70,739
2019-02-26 13:00:00,200,118,82,23,23,23,224,23,716
2019-02-26 14:00:00,177,70,35,11,23,47,200,35,598
2019-02-26 15:00:00,94,11,35,47,11,0,82,0,280
2019-02-26 16:00:00,106,59,11,59,35,47,129,35,481
2019-02-26 17:00:00,35,59,11,0,0,59,82,23,269
2019-02-26 18:00:00,177,11,11,0,0,23,70,35,327
2019-02-26 19:00:00,70,59,0,23,11,11,47,11,232
2019-02-26 20:00:00,47,23,35,11,11,0,82,0,209
2019-02-26 21:00:00,11,0,0,0,0,11,0,11,33
2019-02-26 22:00:00,11,11,11,0,0,0,11,11,55
2019-02-26 23:00:00,11,0,0,11,0,0,0,0,22
2019-02-27 00:00:00,0,0,0,0,0,0,0,0,0
2019-02-27 01:00:00,0,11,0,0,0,0,11,0,22
2019-02-27 02:00:00,0,0,0,0,0,0,0,0,0
2019-02-27 03:00:00,0,0,0,0,0,0,11,0,11
2019-02-27 04:00:00,0,0,0,0,0,0,11,0,11
2019-02-27 05:00:00,23,0,0,0,0,0,0,11,34
2019-02-27 06:00:00,59,0,0,11,0,0,59,23,152
2019-02-27 07:00:00,94,11,23,47,0,0,59,23,257
2019-02-27 08:00:00,129,0,35,0,0,0,23,23,210
2019-02-27 09:00:00,47,11,47,0,11,11,35,35,197
2019-02-27 10:00:00,118,0,35,11,23,0,106,59,352
2019-02-27 11:00:00,177,47,23,11,11,23,106,47,445
2019-02-27 12:00:00,153,82,47,59,0,47,118,118,624
2019-02-27 13:00:00,35,11,35,11,11,23,106,23,255
2019-02-27 14:00:00,165,106,11,0,23,23,118,47,493
2019-02-27 15:00:00,165,129,11,11,0,35,82,23,456
2019-02-27 16:00:00,82,47,23,23,0,0,47,23,245
2019-02-27 17:00:00,94,23,47,11,11,23,70,23,302
2019-02-27 18:00:00,82,11,0,0,59,70,59,0,281
2019-02-27 19:00:00,82,23,0,0,11,0,35,0,151
2019-02-27 20:00:00,23,11,0,11,0,23,47,0,115
2019-02-27 21:00:00,23,11,0,0,11,47,23,11,126
2019-02-27 22:00:00,0,0,0,0,11,35,11,0,57
2019-02-27 23:00:00,0,0,0,0,0,11,35,0,46
2019-02-28 00:00:00,0,11,0,0,0,0,11,11,33
2019-02-28 01:00:00,0,0,0,0,0,0,23,0,23
2019-02-28 02:00:00,11,0,0,0,0,0,23,0,34
2019-02-28 03:00:00,0,0,0,11,0,0,11,0,22
2019-02-28 04:00:00,0,11,0,0,0,0,70,0,81
2019-02-28 05:00:00,0,0,0,0,0,0,11,11,22
2019-02-28 06:00:00,47,11,0,11,0,11,35,11,126
2019-02-28 07:00:00,82,11,11,35,0,47,47,11,244
2019-02-28 08:00:00,70,11,23,0,0,0,106,47,257
2019-02-28 09:00:00,35,11,35,0,23,11,59,11,185
2019-02-28 10:00:00,118,70,82,0,35,47,106,59,517
2019-02-28 11:00:00,141,165,59,11,23,47,200,59,705
2019-02-28 12:00:00,153,94,47,47,11,35,129,35,551
2019-02-28 13:00:00,94,141,59,11,47,70,200,11,633
2019-02-28 14:00:00,200,59,94,35,11,23,236,94,752
2019-02-28 15:00:00,141,106,82,47,35,59,118,35,623
2019-02-28 16:00:00,129,82,35,47,11,70,82,23,479
2019-02-28 17:00:00,70,11,0,0,35,23,82,35,256
2019-02-28 18:00:00,94,35,0,23,11,11,23,11,208
2019-02-28 19:00:00,23,118,0,23,11,23,35,0,233
2019-02-28 20:00:00,106,23,0,11,11,0,47,35,233
2019-02-28 21:00:00,11,23,11,23,141,0,47,0,256
2019-02-28 22:00:00,23,0,0,11,0,0,47,0,81
2019-02-28 23:00:00,11,11,0,11,0,0,23,0,56
2019-03-01 00:00:00,0,0,0,0,0,0,11,0,11
2019-03-01 01:00:00,11,0,11,0,0,0,23,0,45
2019-03-01 02:00:00,0,0,0,0,0,0,11,11,22
2019-03-01 03:00:00,0,0,0,0,0,0,23,0,23
2019-03-01 04:00:00,11,0,0,0,0,0,11,0,22
2019-03-01 05:00:00,23,0,0,0,0,0,35,0,58
2019-03-01 06:00:00,23,0,11,11,0,0,23,0,68
2019-03-01 07:00:00,118,35,11,23,0,0,70,11,268
2019-03-01 08:00:00,141,47,70,23,0,0,70,82,433
2019-03-01 09:00:00,35,82,70,23,0,23,35,11,279
2019-03-01 10:00:00,106,23,47,23,11,23,70,35,338
2019-03-01 11:00:00,129,141,23,23,35,188,236,35,810
2019-03-01 12:00:00,212,106,11,23,0,94,200,82,728
2019-03-01 13:00:00,295,94,23,47,23,59,200,35,776
2019-03-01 14:00:00,236,106,35,59,0,47,129,35,647
2019-03-01 15:00:00,153,106,35,35,47,35,118,59,588
2019-03-01 16:00:00,94,94,23,11,23,35,70,23,373
2019-03-01 17:00:00,35,82,0,11,11,47,59,23,268
2019-03-01 18:00:00,118,23,0,0,11,47,153,0,352
2019-03-01 19:00:00,11,11,11,11,23,0,94,0,161
2019-03-01 20:00:00,59,11,0,0,11,0,35,11,127
2019-03-01 21:00:00,0,23,0,35,11,23,23,0,115
2019-03-01 22:00:00,35,11,0,0,0,11,23,0,80
2019-03-01 23:00:00,0,11,11,0,0,0,70,0,92
2019-03-02 00:00:00,11,11,23,11,0,23,11,0,90
2019-03-02 01:00:00,11,23,23,0,0,11,11,11,90
2019-03-02 02:00:00,236,11,23,0,0,0,23,0,293
2019-03-02 03:00:00,11,0,23,0,0,0,23,0,57
2019-03-02 04:00:00,0,0,11,0,0,0,0,0,11
2019-03-02 05:00:00,11,0,11,0,0,0,23,11,56
2019-03-02 06:00:00,0,0,11,0,0,0,0,0,11
2019-03-02 07:00:00,11,0,23,0,0,0,35,0,69
2019-03-02 08:00:00,0,23,23,0,0,0,59,0,105
2019-03-02 09:00:00,35,11,23,0,0,11,47,11,138
2019-03-02 10:00:00,82,35,23,11,23,35,94,0,303
2019-03-02 11:00:00,153,94,35,11,23,59,94,23,492
2019-03-02 12:00:00,153,94,11,59,11,106,306,23,763
2019-03-02 13:00:00,200,82,11,94,70,153,519,70,1199
2019-03-02 14:00:00,236,177,23,35,35,106,306,23,941
2019-03-02 15:00:00,188,82,35,82,23,59,259,35,763
2019-03-02 16:00:00,106,70,0,0,59,70,129,82,516
2019-03-02 17:00:00,70,82,23,35,11,23,94,0,338
2019-03-02 18:00:00,47,59,0,0,11,11,106,0,234
2019-03-02 19:00:00,82,35,0,0,11,11,82,0,221
2019-03-02 20:00:00,11,11,0,47,11,0,0,0,80
2019-03-02 21:00:00,23,11,0,11,11,0,47,0,103
2019-03-02 22:00:00,23,0,0,11,11,0,11,0,56
2019-03-02 23:00:00,0,0,0,11,0,0,0,0,11
2019-03-03 00:00:00,35,23,0,11,0,0,11,0,80
2019-03-03 01:00:00,23,0,0,11,0,0,23,0,57
2019-03-03 02:00:00,11,0,0,0,0,0,23,0,34
2019-03-03 03:00:00,0,0,0,0,0,0,23,0,23
2019-03-03 04:00:00,0,0,0,0,0,0,23,0,23
2019-03-03 05:00:00,11,0,0,0,0,0,0,0,11
2019-03-03 06:00:00,0,0,0,0,0,0,23,0,23
2019-03-03 07:00:00,11,0,0,0,0,0,23,0,34
2019-03-03 08:00:00,0,0,0,0,0,0,35,0,35
2019-03-03 09:00:00,47,11,0,0,0,0,47,0,105
2019-03-03 10:00:00,35,0,0,23,11,23,35,0,127
2019-03-03 11:00:00,59,59,0,47,11,35,70,35,316
2019-03-03 12:00:00,106,106,0,70,0,188,306,23,799
2019-03-03 13:00:00,295,283,11,70,23,165,424,11,1282
2019-03-03 14:00:00,165,200,11,59,118,165,377,0,1095
2019-03-03 15:00:00,165,59,23,47,82,82,153,35,646
2019-03-03 16:00:00,94,94,11,47,0,70,141,0,457
2019-03-03 17:00:00,35,23,0,47,35,11,177,0,328
2019-03-03 18:00:00,35,59,0,11,0,23,59,23,210
2019-03-03 19:00:00,0,0,0,0,0,0,35,0,35
2019-03-03 20:00:00,11,0,11,11,0,0,35,0,68
2019-03-03 21:00:00,0,0,0,0,0,0,23,0,23
2019-03-03 22:00:00,0,11,0,0,0,0,23,0,34
2019-03-03 23:00:00,0,23,0,0,0,0,0,0,23
2019-03-04 00:00:00,0,0,0,11,0,0,11,0,22
2019-03-04 01:00:00,0,0,0,11,0,0,11,0,22
2019-03-04 02:00:00,0,0,0,11,0,0,0,0,11
2019-03-04 03:00:00,0,0,0,0,0,0,0,0,0
2019-03-04 04:00:00,0,0,0,0,0,0,0,0,0
2019-03-04 05:00:00,0,11,0,11,0,0,35,0,57
2019-03-04 06:00:00,59,0,0,11,0,0,23,11,104
2019-03-04 07:00:00,106,35,0,0,11,0,35,59,246
2019-03-04 08:00:00,94,47,0,23,0,11,82,94,351
2019-03-04 09:00:00,47,23,0,11,0,0,82,23,186
2019-03-04 10:00:00,11,23,11,11,11,0,59,0,126
2019-03-04 11:00:00,35,59,0,23,23,11,94,35,280
2019-03-04 12:00:00,94,94,11,0,11,23,94,47,374
2019-03-04 13:00:00,94,47,23,23,23,59,82,47,398
2019-03-04 14:00:00,153,35,23,23,11,0,82,82,409
2019-03-04 15:00:00,153,11,59,11,0,0,70,23,327
2019-03-04 16:00:00,106,47,11,11,11,11,94,23,314
2019-03-04 17:00:00,23,11,11,11,11,11,70,11,159
2019-03-04 18:00:00,0,11,0,11,11,11,11,0,55
2019-03-04 19:00:00,0,59,11,23,11,11,35,0,150
2019-03-04 20:00:00,35,0,11,0,11,11,47,11,126
2019-03-04 21:00:00,0,11,11,0,11,11,35,0,79
2019-03-04 22:00:00,0,0,0,0,0,0,11,0,11
2019-03-04 23:00:00,0,0,11,11,0,0,35,0,57
2019-03-05 00:00:00,0,0,0,23,0,0,0,11,34
2019-03-05 01:00:00,0,0,0,0,0,0,0,0,0
2019-03-05 02:00:00,0,0,0,0,0,0,0,0,0
2019-03-05 03:00:00,0,0,11,0,0,0,0,0,11
2019-03-05 04:00:00,11,0,0,0,0,0,0,11,22
2019-03-05 05:00:00,11,0,0,0,0,0,0,11,22
2019-03-05 06:00:00,35,11,0,0,0,0,23,11,80
2019-03-05 07:00:00,0,11,0,0,0,0,0,23,34
2019-03-05 08:00:00,106,23,11,23,0,0,35,59,257
2019-03-05 09:00:00,82,0,23,0,0,0,35,47,187
2019-03-05 10:00:00,35,35,23,0,11,11,59,35,209
2019-03-05 11:00:00,70,23,47,11,11,11,47,11,231
2019-03-05 12:00:00,177,70,23,11,11,0,129,94,515
2019-03-05 13:00:00,70,47,35,11,0,11,94,35,303
2019-03-05 14:00:00,129,82,47,0,11,35,94,141,539
2019-03-05 15:00:00,70,70,47,0,23,35,165,35,445
2019-03-05 16:00:00,129,35,0,11,0,11,59,35,280
2019-03-05 17:00:00,94,23,0,0,11,23,70,11,232
2019-03-05 18:00:00,35,23,23,11,70,23,35,11,231
2019-03-05 19:00:00,23,11,23,11,11,0,153,0,232
2019-03-05 20:00:00,11,11,11,0,0,0,35,0,68
2019-03-05 21:00:00,11,0,23,0,35,0,0,0,69
2019-03-05 22:00:00,0,0,0,0,0,23,0,0,23
2019-03-05 23:00:00,0,0,0,0,0,0,0,0,0
2019-03-06 00:00:00,0,0,0,0,0,0,23,0,23
2019-03-06 01:00:00,0,0,0,0,0,0,0,0,0
2019-03-06 02:00:00,0,0,0,0,0,0,11,0,11
2019-03-06 03:00:00,0,0,0,0,0,0,0,0,0
2019-03-06 04:00:00,0,0,0,0,0,0,0,0,0
2019-03-06 05:00:00,11,0,0,0,0,0,0,11,22
2019-03-06 06:00:00,47,0,0,0,0,0,11,0,58
2019-03-06 07:00:00,47,11,0,11,0,0,82,35,186
2019-03-06 08:00:00,106,23,23,0,0,0,59,35,246
2019-03-06 09:00:00,47,11,47,11,82,0,94,11,303
2019-03-06 10:00:00,106,0,59,23,0,0,106,23,317
2019-03-06 11:00:00,59,70,11,11,11,11,165,23,361
2019-03-06 12:00:00,70,236,82,11,0,0,82,59,540
2019-03-06 13:00:00,70,0,59,35,11,0,82,11,268
2019-03-06 14:00:00,129,59,35,11,23,23,82,59,421
2019-03-06 15:00:00,141,70,23,23,0,35,70,11,373
2019-03-06 16:00:00,23,11,11,0,23,11,70,11,160
2019-03-06 17:00:00,47,23,0,0,0,0,35,11,116
2019-03-06 18:00:00,35,59,0,11,0,0,47,0,152
2019-03-06 19:00:00,70,35,0,11,11,11,35,11,184
2019-03-06 20:00:00,0,0,0,0,0,0,70,0,70
2019-03-06 21:00:00,0,0,0,0,0,0,35,0,35
2019-03-06 22:00:00,23,0,0,11,0,0,23,0,57
2019-03-06 23:00:00,0,0,0,0,0,0,11,0,11
2019-03-07 00:00:00,0,0,0,0,0,0,11,0,11
2019-03-07 01:00:00,0,0,0,11,0,0,0,0,11
2019-03-07 02:00:00,0,0,0,0,0,0,0,0,0
2019-03-07 03:00:00,0,0,0,11,0,0,0,0,11
2019-03-07 04:00:00,11,11,0,0,0,0,11,0,33
2019-03-07 05:00:00,11,0,0,0,0,0,0,0,11
2019-03-07 06:00:00,11,0,0,0,0,0,35,0,46
2019-03-07 07:00:00,82,11,0,0,0,11,35,35,174
2019-03-07 08:00:00,94,35,0,0,0,0,23,11,163
2019-03-07 09:00:00,47,0,11,11,11,35,59,11,185
2019-03-07 10:00:00,59,47,11,0,11,59,47,35,269
2019-03-07 11:00:00,47,47,0,0,11,23,118,47,293
2019-03-07 12:00:00,23,23,11,0,0,35,106,23,221
2019-03-07 13:00:00,283,94,0,11,23,35,59,35,540
2019-03-07 14:00:00,259,47,23,0,47,59,318,47,800
2019-03-07 15:00:00,82,47,11,0,47,82,141,35,445
2019-03-07 16:00:00,129,0,11,23,0,23,129,11,326
2019-03-07 17:00:00,177,23,0,11,23,35,47,59,375
2019-03-07 18:00:00,23,11,11,11,23,11,35,0,125
2019-03-07 19:00:00,35,35,70,0,11,11,23,0,185
2019-03-07 20:00:00,35,35,0,0,11,11,23,23,138
2019-03-07 21:00:00,0,0,0,0,11,11,0,11,33
2019-03-07 22:00:00,0,11,0,0,0,0,23,0,34
2019-03-07 23:00:00,0,11,0,0,0,0,11,11,33
2019-03-08 00:00:00,11,0,0,0,0,0,0,0,11
2019-03-08 01:00:00,0,0,0,0,0,0,0,11,11
2019-03-08 02:00:00,0,0,0,0,0,0,35,0,35
2019-03-08 03:00:00,0,0,0,0,0,0,11,0,11
2019-03-08 04:00:00,11,11,0,0,0,0,0,0,22
2019-03-08 05:00:00,23,11,0,0,0,0,23,0,57
2019-03-08 06:00:00,35,0,11,0,0,0,11,0,57
2019-03-08 07:00:00,70,0,0,0,23,0,11,23,127
2019-03-08 08:00:00,118,47,23,0,0,11,23,118,340
2019-03-08 09:00:00,106,11,11,0,35,11,47,0,221
2019-03-08 10:00:00,94,23,23,0,0,0,47,47,234
2019-03-08 11:00:00,35,59,11,11,11,0,82,11,220
2019-03-08 12:00:00,165,118,59,0,59,11,47,47,506
2019-03-08 13:00:00,94,118,35,0,23,23,70,11,374
2019-03-08 14:00:00,342,35,47,0,35,35,106,23,623
2019-03-08 15:00:00,106,82,35,0,23,11,94,23,374
2019-03-08 16:00:00,47,70,11,11,23,47,94,70,373
2019-03-08 17:00:00,118,23,23,11,23,0,70,35,303
2019-03-08 18:00:00,11,47,23,11,11,23,94,35,255
2019-03-08 19:00:00,35,23,0,11,23,59,23,0,174
2019-03-08 20:00:00,23,0,0,0,0,35,23,0,81
2019-03-08 21:00:00,35,11,0,11,0,11,23,47,138
2019-03-08 22:00:00,0,11,0,11,0,23,35,23,103
2019-03-08 23:00:00,11,23,0,0,35,35,47,0,151
2019-03-09 00:00:00,59,11,0,0,11,70,35,35,221
2019-03-09 01:00:00,0,0,0,11,0,35,59,35,140
2019-03-09 02:00:00,11,0,0,11,11,0,23,0,56
2019-03-09 03:00:00,11,0,0,0,0,23,11,0,45
2019-03-09 04:00:00,0,0,0,0,0,0,11,0,11
2019-03-09 05:00:00,0,0,0,0,0,0,23,0,23
2019-03-09 06:00:00,0,0,0,0,0,0,11,0,11
2019-03-09 07:00:00,11,11,11,0,0,0,23,0,56
2019-03-09 08:00:00,0,0,0,0,0,0,47,0,47
2019-03-09 09:00:00,35,11,0,0,11,11,59,0,127
2019-03-09 10:00:00,23,35,0,0,23,35,106,0,222
2019-03-09 11:00:00,47,94,0,0,11,35,82,11,280
2019-03-09 12:00:00,35,212,11,0,23,23,200,0,504
2019-03-09 13:00:00,118,94,23,11,0,35,236,0,517
2019-03-09 14:00:00,59,188,11,11,23,70,342,23,727
2019-03-09 15:00:00,82,106,0,23,23,70,118,47,469
2019-03-09 16:00:00,35,70,0,11,11,23,106,0,256
2019-03-09 17:00:00,118,35,0,0,23,23,141,0,340
2019-03-09 18:00:00,23,35,0,0,0,0,118,0,176
2019-03-09 19:00:00,47,23,0,0,0,0,11,11,92
2019-03-09 20:00:00,23,23,0,0,0,0,11,0,57
2019-03-09 21:00:00,23,0,23,11,0,23,35,23,138
2019-03-09 22:00:00,11,0,11,0,0,0,47,0,69
2019-03-09 23:00:00,59,11,11,0,0,0,35,47,163
2019-03-10 00:00:00,23,11,11,0,0,0,0,0,45
2019-03-10 01:00:00,0,11,23,0,0,0,11,11,56
2019-03-10 02:00:00,0,0,0,0,0,0,23,11,34
2019-03-10 03:00:00,0,0,0,0,0,0,23,0,23
2019-03-10 04:00:00,0,0,23,0,0,0,0,0,23
2019-03-10 05:00:00,0,0,0,0,0,0,0,0,0
2019-03-10 06:00:00,0,0,0,11,0,0,0,0,11
2019-03-10 07:00:00,0,0,0,0,0,0,0,0,0
2019-03-10 08:00:00,11,11,0,0,0,0,23,0,45
2019-03-10 09:00:00,0,11,0,11,0,0,11,0,33
2019-03-10 10:00:00,11,35,0,35,11,11,23,0,126
2019-03-10 11:00:00,106,188,35,47,0,70,200,35,681
2019-03-10 12:00:00,271,354,11,82,70,129,696,35,1648
2019-03-10 13:00:00,436,389,23,106,70,94,767,82,1967
2019-03-10 14:00:00,318,342,59,106,70,141,802,70,1908
2019-03-10 15:00:00,236,177,11,23,94,177,330,35,1083
2019-03-10 16:00:00,212,94,11,0,59,94,212,47,729
2019-03-10 17:00:00,129,35,0,0,23,35,47,23,292
2019-03-10 18:00:00,70,59,11,23,35,0,94,47,339
2019-03-10 19:00:00,23,23,23,23,11,35,35,11,184
2019-03-10 20:00:00,11,0,0,0,0,11,35,11,68
2019-03-10 21:00:00,23,59,0,0,11,35,23,0,151
2019-03-10 22:00:00,0,0,11,0,0,0,47,0,58
2019-03-10 23:00:00,0,0,23,0,0,23,0,11,57
2019-03-11 00:00:00,0,0,23,0,0,0,11,0,34
2019-03-11 01:00:00,0,0,0,0,0,0,0,0,0
2019-03-11 02:00:00,0,0,11,0,0,0,0,0,11
2019-03-11 03:00:00,0,0,11,0,0,0,0,0,11
2019-03-11 04:00:00,0,11,0,0,0,0,0,0,11
2019-03-11 05:00:00,11,11,0,0,0,0,0,0,22
2019-03-11 06:00:00,35,35,0,11,11,0,23,11,126
2019-03-11 07:00:00,106,47,0,23,0,11,11,11,209
2019-03-11 08:00:00,129,35,23,23,23,23,23,106,385
2019-03-11 09:00:00,82,59,35,35,0,0,23,23,257
2019-03-11 10:00:00,82,0,59,23,35,0,70,11,280
2019-03-11 11:00:00,59,82,11,0,0,0,59,23,234
2019-03-11 12:00:00,94,59,47,35,11,70,118,23,457
2019-03-11 13:00:00,153,70,35,23,47,47,118,82,575
2019-03-11 14:00:00,200,82,35,11,11,94,141,153,727
2019-03-11 15:00:00,212,23,47,11,23,106,59,47,528
2019-03-11 16:00:00,94,259,11,23,23,23,200,35,668
2019-03-11 17:00:00,129,11,11,11,35,200,82,23,502
2019-03-11 18:00:00,47,11,11,0,11,23,11,11,125
2019-03-11 19:00:00,35,23,23,0,0,0,59,0,140
2019-03-11 20:00:00,59,11,0,0,0,0,11,23,104
2019-03-11 21:00:00,11,0,11,0,11,0,35,0,68
2019-03-11 22:00:00,0,0,0,0,0,0,0,0,0
2019-03-11 23:00:00,0,0,0,0,0,0,23,0,23
2019-03-12 00:00:00,11,23,0,0,0,0,59,0,93
2019-03-12 01:00:00,11,11,0,0,0,0,23,0,45
2019-03-12 02:00:00,11,0,0,0,0,0,23,0,34
2019-03-12 03:00:00,0,0,0,11,0,0,23,11,45
2019-03-12 04:00:00,11,11,0,11,0,0,47,0,80
2019-03-12 05:00:00,0,0,0,23,0,0,23,0,46
2019-03-12 06:00:00,11,35,0,11,0,0,11,11,79
2019-03-12 07:00:00,70,35,0,11,0,0,35,23,174
2019-03-12 08:00:00,94,23,35,11,11,11,118,35,338
2019-03-12 09:00:00,59,23,11,0,23,23,70,23,232
2019-03-12 10:00:00,70,47,35,11,23,11,129,35,361
2019-03-12 11:00:00,59,35,23,0,59,23,129,47,375
2019-03-12 12:00:00,94,70,47,23,11,23,153,59,480
2019-03-12 13:00:00,129,118,47,11,23,47,377,94,846
2019-03-12 14:00:00,153,70,23,35,35,11,165,23,515
2019-03-12 15:00:00,118,47,47,23,47,11,70,11,374
2019-03-12 16:00:00,94,23,0,0,23,0,118,0,258
2019-03-12 17:00:00,47,0,0,11,0,11,70,11,150
2019-03-12 18:00:00,11,11,0,0,23,0,59,11,115
2019-03-12 19:00:00,106,23,0,0,11,23,59,0,222
2019-03-12 20:00:00,35,11,0,0,0,11,23,0,80
2019-03-12 21:00:00,47,0,0,0,0,0,0,23,70
2019-03-12 22:00:00,23,0,0,0,0,11,0,0,34
2019-03-12 23:00:00,0,0,0,0,0,0,0,11,11
2019-03-13 00:00:00,11,0,0,0,0,0,11,0,22
2019-03-13 01:00:00,0,0,0,0,0,0,0,0,0
2019-03-13 02:00:00,0,0,0,0,0,0,0,0,0
2019-03-13 03:00:00,0,11,0,0,0,0,11,0,22
2019-03-13 04:00:00,11,11,0,0,0,0,0,0,22
2019-03-13 05:00:00,23,0,0,0,0,0,11,11,45
2019-03-13 06:00:00,70,11,0,0,0,0,11,0,92
2019-03-13 07:00:00,106,35,23,0,0,0,47,23,234
2019-03-13 08:00:00,106,11,47,0,11,0,11,35,221
2019-03-13 09:00:00,35,11,11,0,23,0,47,47,174
2019-03-13 10:00:00,35,47,35,11,70,0,35,59,292
2019-03-13 11:00:00,47,11,0,11,11,23,70,23,196
2019-03-13 12:00:00,59,59,11,0,23,0,70,35,257
2019-03-13 13:00:00,35,35,0,11,35,11,82,0,209
2019-03-13 14:00:00,141,59,0,0,0,11,94,0,305
2019-03-13 15:00:00,35,11,35,23,11,11,70,47,243
2019-03-13 16:00:00,47,47,11,0,0,0,35,23,163
2019-03-13 17:00:00,59,0,23,0,0,0,23,11,116
2019-03-13 18:00:00,35,0,0,0,11,0,70,35,151
2019-03-13 19:00:00,106,11,0,0,11,0,0,11,139
2019-03-13 20:00:00,47,0,0,0,23,0,23,11,104
2019-03-13 21:00:00,0,11,0,0,11,0,0,23,45
2019-03-13 22:00:00,0,11,0,11,11,0,11,0,44
2019-03-13 23:00:00,0,0,0,0,0,11,23,0,34
2019-03-14 00:00:00,0,0,0,0,0,0,11,0,11
2019-03-14 01:00:00,11,0,0,0,0,0,11,0,22
2019-03-14 02:00:00,11,0,0,0,0,0,0,0,11
2019-03-14 03:00:00,11,0,0,0,0,0,11,11,33
2019-03-14 04:00:00,0,0,0,0,0,0,0,0,0
2019-03-14 05:00:00,11,0,0,0,0,0,0,0,11
2019-03-14 06:00:00,23,0,0,0,0,0,59,11,93
2019-03-14 07:00:00,82,11,0,0,0,0,59,23,175
2019-03-14 08:00:00,70,35,47,0,11,0,11,11,185
2019-03-14 09:00:00,47,35,35,0,35,11,35,0,198
2019-03-14 10:00:00,47,11,59,0,11,11,23,23,185
2019-03-14 11:00:00,82,94,23,0,0,35,129,11,374
2019-03-14 12:00:00,106,47,47,23,23,23,118,23,410
2019-03-14 13:00:00,129,47,11,0,11,35,106,35,374
2019-03-14 14:00:00,82,106,35,11,59,47,165,23,528
2019-03-14 15:00:00,141,47,70,23,11,23,118,23,456
2019-03-14 16:00:00,118,70,11,35,0,23,35,23,315
2019-03-14 17:00:00,23,23,0,23,0,23,82,0,174
2019-03-14 18:00:00,35,35,0,11,23,59,35,11,209
2019-03-14 19:00:00,47,23,0,0,11,47,59,0,187
2019-03-14 20:00:00,0,11,0,0,0,23,0,0,34
2019-03-14 21:00:00,11,0,0,0,0,0,0,11,22
2019-03-14 22:00:00,11,0,0,0,0,0,23,0,34
2019-03-14 23:00:00,47,35,0,0,11,35,11,11,150
2019-03-15 00:00:00,11,82,0,0,0,0,11,0,104
2019-03-15 01:00:00,0,23,0,0,11,11,0,0,45
2019-03-15 02:00:00,0,0,0,0,0,0,0,0,0
2019-03-15 03:00:00,0,0,0,0,0,0,0,0,0
2019-03-15 04:00:00,0,0,0,35,0,0,0,0,35
2019-03-15 05:00:00,0,0,0,0,0,0,0,0,0
2019-03-15 06:00:00,23,11,0,0,0,0,11,0,45
2019-03-15 07:00:00,94,0,11,11,0,0,11,35,162
2019-03-15 08:00:00,141,35,11,0,0,11,59,106,363
2019-03-15 09:00:00,70,0,11,0,35,0,23,11,150
2019-03-15 10:00:00,59,35,23,0,23,11,82,47,280
2019-03-15 11:00:00,59,59,47,23,23,47,82,23,363
2019-03-15 12:00:00,295,59,35,11,23,59,224,35,741
2019-03-15 13:00:00,118,70,0,11,11,11,59,11,291
2019-03-15 14:00:00,259,47,23,11,23,23,70,35,491
2019-03-15 15:00:00,70,82,35,0,0,11,70,11,279
2019-03-15 16:00:00,82,35,0,0,0,35,82,0,234
2019-03-15 17:00:00,23,35,0,11,0,0,70,0,139
2019-03-15 18:00:00,59,11,11,23,0,35,47,11,197
2019-03-15 19:00:00,94,0,0,0,0,0,35,0,129
2019-03-15 20:00:00,35,0,0,0,0,23,59,0,117
2019-03-15 21:00:00,23,23,0,23,23,70,35,11,208
2019-03-15 22:00:00,35,0,0,23,0,0,59,0,117
2019-03-15 23:00:00,23,23,0,11,0,35,35,0,127
2019-03-16 00:00:00,11,0,0,11,0,35,35,23,115
2019-03-16 01:00:00,11,0,0,0,11,23,35,0,80
2019-03-16 02:00:00,11,0,0,11,0,11,11,0,44
2019-03-16 03:00:00,11,0,0,0,11,0,23,0,45
2019-03-16 04:00:00,0,0,0,0,0,0,23,0,23
2019-03-16 05:00:00,0,0,0,0,0,0,47,0,47
2019-03-16 06:00:00,0,11,0,0,0,0,23,0,34
2019-03-16 07:00:00,11,47,0,0,0,0,47,0,105
2019-03-16 08:00:00,0,35,0,11,0,0,59,0,105
2019-03-16 09:00:00,11,23,0,23,11,0,35,0,103
2019-03-16 10:00:00,23,59,0,0,23,0,70,23,198
2019-03-16 11:00:00,59,165,0,11,35,47,141,35,493
2019-03-16 12:00:00,141,306,0,35,11,153,389,35,1070
2019-03-16 13:00:00,212,141,0,59,47,94,448,59,1060
2019-03-16 14:00:00,236,259,23,0,47,70,377,35,1047
2019-03-16 15:00:00,247,141,0,70,94,106,365,47,1070
2019-03-16 16:00:00,212,59,11,35,177,59,129,35,717
2019-03-16 17:00:00,129,47,0,23,35,11,59,11,315
2019-03-16 18:00:00,106,47,0,0,11,70,82,0,316
2019-03-16 19:00:00,153,35,11,11,23,0,70,0,303
2019-03-16 20:00:00,35,0,0,0,0,0,23,0,58
2019-03-16 21:00:00,11,0,0,0,23,0,82,11,127
2019-03-16 22:00:00,70,11,0,0,11,0,70,11,173
2019-03-16 23:00:00,23,0,0,0,11,0,59,0,93
2019-03-17 00:00:00,0,0,0,0,0,0,47,0,47
2019-03-17 01:00:00,11,11,0,0,0,0,35,0,57
2019-03-17 02:00:00,0,0,0,0,0,0,59,0,59
2019-03-17 03:00:00,11,0,0,0,0,0,47,11,69
2019-03-17 04:00:00,0,0,0,0,0,0,59,0,59
2019-03-17 05:00:00,0,0,0,0,0,0,47,0,47
2019-03-17 06:00:00,0,0,0,0,0,0,70,0,70
2019-03-17 07:00:00,0,0,0,0,0,0,35,0,35
2019-03-17 08:00:00,23,23,0,0,0,0,47,11,104
2019-03-17 09:00:00,0,23,0,0,0,0,59,0,82
2019-03-17 10:00:00,23,11,0,0,0,0,94,0,128
2019-03-17 11:00:00,11,11,0,0,0,11,82,0,115
2019-03-17 12:00:00,59,47,11,11,35,35,153,0,351
2019-03-17 13:00:00,47,507,0,11,35,23,106,11,740
2019-03-17 14:00:00,35,82,0,23,0,59,70,11,280
2019-03-17 15:00:00,59,47,11,23,47,82,59,0,328
2019-03-17 16:00:00,11,47,0,0,11,23,94,0,186
2019-03-17 17:00:00,35,11,0,11,11,23,35,35,161
2019-03-17 18:00:00,35,35,23,11,11,11,70,23,219
2019-03-17 19:00:00,11,59,0,0,0,0,70,0,140
2019-03-17 20:00:00,23,0,0,11,11,0,23,0,68
2019-03-17 21:00:00,0,0,0,11,11,0,11,11,44
2019-03-17 22:00:00,11,0,11,0,0,0,11,0,33
2019-03-17 23:00:00,11,0,0,0,0,0,0,0,11
2019-03-18 00:00:00,0,0,0,0,0,0,0,0,0
2019-03-18 01:00:00,0,0,0,0,0,0,23,0,23
2019-03-18 02:00:00,0,0,0,0,0,0,0,0,0
2019-03-18 03:00:00,0,0,0,0,0,0,0,0,0
2019-03-18 04:00:00,0,0,0,0,0,0,0,0,0
2019-03-18 05:00:00,0,23,0,0,0,0,35,0,58
2019-03-18 06:00:00,47,11,0,0,0,0,23,11,92
2019-03-18 07:00:00,70,23,11,11,0,0,23,23,161
2019-03-18 08:00:00,82,11,0,0,0,0,82,59,234
2019-03-18 09:00:00,153,59,11,0,11,0,59,11,304
2019-03-18 10:00:00,59,35,0,0,0,0,106,0,200
2019-03-18 11:00:00,59,47,0,0,11,11,70,35,233
2019-03-18 12:00:00,188,153,35,35,11,47,153,70,692
2019-03-18 13:00:00,106,23,94,11,11,35,153,35,468
2019-03-18 14:00:00,236,59,47,23,0,0,165,59,589
2019-03-18 15:00:00,224,94,35,0,11,23,177,47,611
2019-03-18 16:00:00,129,11,23,35,23,0,82,23,326
2019-03-18 17:00:00,129,59,0,11,11,23,47,35,315
2019-03-18 18:00:00,47,35,11,0,23,0,82,11,209
2019-03-18 19:00:00,59,177,0,0,0,23,47,0,306
2019-03-18 20:00:00,11,11,0,0,0,11,0,0,33
2019-03-18 21:00:00,11,0,0,0,0,0,35,0,46
2019-03-18 22:00:00,11,0,0,0,0,0,23,0,34
2019-03-18 23:00:00,11,23,0,0,0,0,0,0,34
2019-03-19 00:00:00,0,0,0,0,0,0,0,0,0
2019-03-19 01:00:00,11,0,0,0,0,0,11,0,22
2019-03-19 02:00:00,11,0,0,0,0,0,0,0,11
2019-03-19 03:00:00,0,0,0,0,0,0,0,0,0
2019-03-19 04:00:00,0,0,0,0,0,0,11,0,11
2019-03-19 05:00:00,47,0,0,0,0,0,23,0,70
2019-03-19 06:00:00,47,0,0,0,0,0,11,0,58
2019-03-19 07:00:00,118,0,0,0,0,0,47,11,176
2019-03-19 08:00:00,118,11,47,0,0,11,70,59,316
2019-03-19 09:00:00,47,47,23,11,0,0,106,23,257
2019-03-19 10:00:00,165,35,35,11,23,0,118,11,398
2019-03-19 11:00:00,94,47,23,11,11,23,165,47,421
2019-03-19 12:00:00,129,224,0,11,23,47,141,70,645
2019-03-19 13:00:00,177,129,82,23,59,35,129,47,681
2019-03-19 14:00:00,271,141,11,11,35,94,177,70,810
2019-03-19 15:00:00,165,94,11,11,11,47,177,23,539
2019-03-19 16:00:00,188,82,11,23,11,0,70,23,408
2019-03-19 17:00:00,188,35,11,0,11,11,94,11,361
2019-03-19 18:00:00,70,23,11,11,23,11,118,59,326
2019-03-19 19:00:00,118,23,0,0,0,0,70,11,222
2019-03-19 20:00:00,47,94,0,0,0,0,59,11,211
2019-03-19 21:00:00,94,11,0,11,11,11,47,0,185
2019-03-19 22:00:00,23,0,0,0,0,23,11,0,57
2019-03-19 23:00:00,11,0,0,0,0,0,35,0,46
2019-03-20 00:00:00,0,0,0,0,0,0,35,11,46
2019-03-20 01:00:00,0,0,0,0,0,0,23,0,23
2019-03-20 02:00:00,11,0,0,0,0,0,23,0,34
2019-03-20 03:00:00,0,0,0,0,0,0,11,0,11
2019-03-20 04:00:00,0,0,0,0,0,0,0,0,0
2019-03-20 05:00:00,0,0,0,0,0,0,23,0,23
2019-03-20 06:00:00,23,35,0,0,0,11,11,11,91
2019-03-20 07:00:00,94,11,0,11,0,11,59,0,186
2019-03-20 08:00:00,188,23,23,0,0,11,82,106,433
2019-03-20 09:00:00,94,23,35,11,11,0,59,0,233
2019-03-20 10:00:00,200,59,47,11,11,35,118,35,516
2019-03-20 11:00:00,153,141,0,23,47,47,153,47,611
2019-03-20 12:00:00,153,94,35,35,11,59,177,23,587
2019-03-20 13:00:00,59,94,70,0,35,47,188,118,611
2019-03-20 14:00:00,200,82,0,0,23,59,247,47,658
2019-03-20 15:00:00,224,23,11,0,35,70,141,59,563
2019-03-20 16:00:00,141,70,23,59,23,47,70,35,468
2019-03-20 17:00:00,129,35,0,0,59,23,118,11,375
2019-03-20 18:00:00,106,70,11,35,47,35,59,0,363
2019-03-20 19:00:00,141,47,11,0,0,11,35,35,280
2019-03-20 20:00:00,82,11,0,0,0,23,47,11,174
2019-03-20 21:00:00,11,0,0,11,0,0,23,0,45
2019-03-20 22:00:00,82,0,0,0,0,11,0,0,93
2019-03-20 23:00:00,23,0,11,0,0,11,11,0,56
2019-03-21 00:00:00,0,11,0,0,0,11,11,0,33
2019-03-21 01:00:00,0,11,11,0,0,0,11,0,33
2019-03-21 02:00:00,0,0,23,0,0,0,23,0,46
2019-03-21 03:00:00,0,0,35,0,0,0,11,11,57
2019-03-21 04:00:00,0,0,23,0,0,0,0,0,23
2019-03-21 05:00:00,82,0,23,0,0,0,0,11,116
2019-03-21 06:00:00,47,23,23,0,0,0,11,11,115
2019-03-21 07:00:00,47,0,11,0,0,11,47,23,139
2019-03-21 08:00:00,141,70,11,0,0,0,23,47,292
2019-03-21 09:00:00,82,11,0,23,0,11,59,0,186
2019-03-21 10:00:00,82,47,82,11,0,0,188,35,445
2019-03-21 11:00:00,141,23,23,23,35,35,153,11,444
2019-03-21 12:00:00,165,47,47,0,47,35,212,23,576
2019-03-21 13:00:00,129,129,11,23,23,23,153,23,514
2019-03-21 14:00:00,165,35,35,11,59,35,118,59,517
2019-03-21 15:00:00,141,23,11,35,11,59,141,11,432
2019-03-21 16:00:00,70,82,11,23,47,118,82,23,456
2019-03-21 17:00:00,106,23,0,11,0,23,106,11,280
2019-03-21 18:00:00,129,11,0,11,47,23,11,11,243
2019-03-21 19:00:00,70,35,11,0,23,11,11,0,161
2019-03-21 20:00:00,70,23,11,11,23,23,47,0,208
2019-03-21 21:00:00,11,35,0,23,35,0,23,0,127
2019-03-21 22:00:00,11,11,0,0,0,11,35,11,79
2019-03-21 23:00:00,0,23,0,0,0,11,11,11,56
2019-03-22 00:00:00,0,0,0,0,0,0,23,0,23
2019-03-22 01:00:00,0,0,0,0,0,0,0,0,0
2019-03-22 02:00:00,11,0,0,0,0,0,0,0,11
2019-03-22 03:00:00,0,0,0,0,0,0,0,0,0
2019-03-22 04:00:00,11,0,0,0,0,0,11,0,22
2019-03-22 05:00:00,11,0,0,0,0,0,23,0,34
2019-03-22 06:00:00,70,35,11,0,0,0,70,11,197
2019-03-22 07:00:00,70,23,11,0,0,0,70,23,197
2019-03-22 08:00:00,94,47,11,0,0,23,82,70,327
2019-03-22 09:00:00,59,35,0,11,0,0,70,35,210
2019-03-22 10:00:00,59,11,0,0,0,11,82,70,233
2019-03-22 11:00:00,129,70,0,0,47,35,153,11,445
2019-03-22 12:00:00,153,70,35,0,11,35,94,59,457
2019-03-22 13:00:00,153,129,0,0,0,0,141,23,446
2019-03-22 14:00:00,165,11,23,0,11,47,141,35,433
2019-03-22 15:00:00,118,47,23,0,11,11,118,11,339
2019-03-22 16:00:00,70,35,0,0,11,23,82,23,244
2019-03-22 17:00:00,47,23,0,11,0,11,70,11,173
2019-03-22 18:00:00,35,0,0,0,11,23,82,0,151
2019-03-22 19:00:00,47,0,0,0,0,11,70,0,128
2019-03-22 20:00:00,11,23,0,0,0,59,47,0,140
2019-03-22 21:00:00,23,23,0,0,11,23,47,0,127
2019-03-22 22:00:00,118,11,0,0,0,11,11,0,151
2019-03-22 23:00:00,0,0,0,0,0,35,35,0,70
2019-03-23 00:00:00,35,0,0,0,0,23,82,11,151
2019-03-23 01:00:00,11,0,0,0,0,47,35,11,104
2019-03-23 02:00:00,70,0,0,0,0,11,0,0,81
2019-03-23 03:00:00,0,0,11,0,0,0,35,0,46
2019-03-23 04:00:00,0,0,11,0,0,0,0,0,11
2019-03-23 05:00:00,0,0,0,0,0,0,11,0,11
2019-03-23 06:00:00,0,0,0,11,0,0,47,11,69
2019-03-23 07:00:00,11,0,0,0,0,0,35,0,46
2019-03-23 08:00:00,11,0,11,0,0,0,11,0,33
2019-03-23 09:00:00,82,35,0,11,11,0,82,0,221
2019-03-23 10:00:00,59,129,35,11,11,23,165,70,503
2019-03-23 11:00:00,141,129,0,35,11,59,295,35,705
2019-03-23 12:00:00,247,271,0,11,94,153,531,23,1330
2019-03-23 13:00:00,295,200,0,59,59,212,649,59,1533
2019-03-23 14:00:00,283,165,35,70,59,165,519,35,1331
2019-03-23 15:00:00,200,94,23,0,23,59,295,23,717
2019-03-23 16:00:00,177,70,0,47,35,118,224,47,718
2019-03-23 17:00:00,188,59,11,11,11,59,141,82,562
2019-03-23 18:00:00,94,82,23,11,11,0,94,11,326
2019-03-23 19:00:00,59,35,0,23,23,11,94,23,268
2019-03-23 20:00:00,23,11,0,11,0,0,35,23,103
2019-03-23 21:00:00,23,23,0,0,0,0,47,11,104
2019-03-23 22:00:00,11,11,0,0,0,11,47,23,103
2019-03-23 23:00:00,23,0,0,0,0,0,11,0,34
2019-03-24 00:00:00,118,11,0,0,0,0,11,11,151
2019-03-24 01:00:00,141,0,0,0,0,0,23,23,187
2019-03-24 02:00:00,0,11,0,0,0,0,35,23,69
2019-03-24 03:00:00,11,0,0,0,0,0,0,0,11
2019-03-24 04:00:00,0,0,0,0,0,0,0,0,0
2019-03-24 05:00:00,0,0,0,0,0,0,0,0,0
2019-03-24 06:00:00,11,0,0,0,0,0,11,11,33
2019-03-24 07:00:00,0,0,0,0,0,0,23,0,23
2019-03-24 08:00:00,11,11,0,0,0,11,35,11,79
2019-03-24 09:00:00,47,35,0,0,0,0,35,0,117
2019-03-24 10:00:00,0,413,0,0,11,11,23,23,481
2019-03-24 11:00:00,94,94,23,23,23,82,401,11,751
2019-03-24 12:00:00,247,188,35,23,47,129,531,59,1259
2019-03-24 13:00:00,200,271,23,11,70,165,295,23,1058
2019-03-24 14:00:00,188,70,11,35,11,82,247,11,655
2019-03-24 15:00:00,129,106,23,23,11,82,177,23,574
2019-03-24 16:00:00,342,47,0,0,0,35,35,0,459
2019-03-24 17:00:00,47,23,0,11,47,23,106,47,304
2019-03-24 18:00:00,82,11,0,11,0,11,59,23,197
2019-03-24 19:00:00,35,0,0,0,0,0,35,11,81
2019-03-24 20:00:00,11,0,0,11,0,0,11,0,33
2019-03-24 21:00:00,23,0,0,0,0,0,23,11,57
2019-03-24 22:00:00,0,0,0,0,0,0,11,0,11
2019-03-24 23:00:00,11,23,0,0,0,0,23,0,57
2019-03-25 00:00:00,11,11,0,0,0,0,23,0,45
2019-03-25 01:00:00,11,0,0,0,0,0,0,0,11
2019-03-25 02:00:00,0,0,0,0,0,0,23,0,23
2019-03-25 03:00:00,0,0,0,0,0,0,0,0,0
2019-03-25 04:00:00,0,0,0,0,0,0,0,0,0
2019-03-25 05:00:00,11,0,0,0,0,0,0,0,11
2019-03-25 06:00:00,59,11,0,0,0,0,35,0,105
2019-03-25 07:00:00,129,11,0,11,0,0,82,23,256
2019-03-25 08:00:00,177,23,23,0,0,11,35,106,375
2019-03-25 09:00:00,82,47,11,0,0,0,47,0,187
2019-03-25 10:00:00,118,11,11,11,11,23,59,0,244
2019-03-25 11:00:00,70,35,11,0,11,35,106,0,268
2019-03-25 12:00:00,23,23,11,0,35,82,70,70,314
2019-03-25 13:00:00,141,106,47,0,11,35,153,11,504
2019-03-25 14:00:00,295,70,118,23,23,11,188,106,834
2019-03-25 15:00:00,200,70,106,11,11,11,129,35,573
2019-03-25 16:00:00,141,47,23,0,35,47,82,47,422
2019-03-25 17:00:00,94,59,23,23,23,59,82,11,374
2019-03-25 18:00:00,94,47,23,11,11,47,59,23,315
2019-03-25 19:00:00,23,35,23,11,11,0,59,23,185
2019-03-25 20:00:00,35,23,23,0,0,0,11,23,115
2019-03-25 21:00:00,35,0,11,0,11,23,23,0,103
2019-03-25 22:00:00,11,0,35,0,0,0,0,0,46
2019-03-25 23:00:00,0,11,11,0,0,0,23,0,45
2019-03-26 00:00:00,11,47,0,0,11,0,11,11,91
2019-03-26 01:00:00,0,11,0,0,0,11,0,0,22
2019-03-26 02:00:00,0,0,0,0,0,0,0,0,0
2019-03-26 03:00:00,0,0,0,0,0,0,0,0,0
2019-03-26 04:00:00,0,0,0,0,0,0,0,0,0
2019-03-26 05:00:00,11,0,0,0,0,0,0,0,11
2019-03-26 06:00:00,35,23,0,0,0,0,23,11,92
2019-03-26 07:00:00,129,35,23,0,0,0,35,23,245
2019-03-26 08:00:00,94,35,11,0,0,11,35,94,280
2019-03-26 09:00:00,118,11,11,0,11,0,47,59,257
2019-03-26 10:00:00,118,70,23,11,11,0,35,0,268
2019-03-26 11:00:00,354,59,35,11,23,11,165,35,693
2019-03-26 12:00:00,177,129,59,11,11,82,82,82,633
2019-03-26 13:00:00,247,82,47,0,11,70,224,47,728
2019-03-26 14:00:00,200,82,47,0,0,35,82,47,493
2019-03-26 15:00:00,129,59,35,0,35,0,106,35,399
2019-03-26 16:00:00,94,70,11,0,0,11,47,0,233
2019-03-26 17:00:00,82,47,11,0,0,35,70,0,245
2019-03-26 18:00:00,82,23,11,0,0,23,94,23,256
2019-03-26 19:00:00,70,11,0,0,0,0,35,23,139
2019-03-26 20:00:00,11,11,0,0,0,11,35,11,79
2019-03-26 21:00:00,70,23,0,11,11,11,0,0,126
2019-03-26 22:00:00,0,0,0,0,11,0,11,11,33
2019-03-26 23:00:00,0,11,0,0,0,11,0,0,22
2019-03-27 00:00:00,11,0,0,0,0,0,11,0,22
2019-03-27 01:00:00,0,0,0,0,0,0,0,11,11
2019-03-27 02:00:00,0,0,0,0,0,0,11,0,11
2019-03-27 03:00:00,0,0,0,0,0,0,0,0,0
2019-03-27 04:00:00,0,0,0,0,0,0,0,0,0
2019-03-27 05:00:00,35,0,0,0,0,0,23,23,81
2019-03-27 06:00:00,70,11,0,0,0,0,23,35,139
2019-03-27 07:00:00,47,11,0,11,0,0,47,47,163
2019-03-27 08:00:00,106,11,11,0,0,0,23,129,280
2019-03-27 09:00:00,59,70,0,0,0,0,35,0,164
2019-03-27 10:00:00,118,35,47,11,23,47,153,35,469
2019-03-27 11:00:00,165,94,94,0,23,82,129,59,646
2019-03-27 12:00:00,224,106,35,35,11,11,247,35,704
2019-03-27 13:00:00,165,59,35,11,47,35,188,106,646
2019-03-27 14:00:00,236,82,0,23,11,35,177,82,646
2019-03-27 15:00:00,188,59,11,23,11,35,165,35,527
2019-03-27 16:00:00,165,177,11,11,0,35,59,47,505
2019-03-27 17:00:00,106,47,11,0,23,47,70,47,351
2019-03-27 18:00:00,118,35,11,11,11,47,94,23,350
2019-03-27 19:00:00,82,11,0,0,23,0,11,0,127
2019-03-27 20:00:00,47,35,0,0,0,0,23,0,105
2019-03-27 21:00:00,47,11,11,0,11,23,11,11,125
2019-03-27 22:00:00,0,11,0,23,23,35,0,11,103
2019-03-27 23:00:00,23,0,0,0,23,0,11,11,68
2019-03-28 00:00:00,11,0,0,0,0,23,23,0,57
2019-03-28 01:00:00,23,0,0,0,0,11,0,0,34
2019-03-28 02:00:00,0,0,0,0,0,0,0,0,0
2019-03-28 03:00:00,0,0,0,0,0,0,0,0,0
2019-03-28 04:00:00,0,0,0,0,0,0,11,0,11
2019-03-28 05:00:00,0,11,0,0,0,0,35,0,46
2019-03-28 06:00:00,35,23,0,0,0,0,23,0,81
2019-03-28 07:00:00,59,47,0,0,0,0,35,35,176
2019-03-28 08:00:00,70,59,0,59,0,0,35,59,282
2019-03-28 09:00:00,106,59,11,0,0,0,106,47,329
2019-03-28 10:00:00,165,82,23,11,11,23,94,47,456
2019-03-28 11:00:00,165,129,47,47,35,59,177,35,694
2019-03-28 12:00:00,236,153,23,35,129,70,236,106,988
2019-03-28 13:00:00,401,401,35,59,59,188,354,94,1591
2019-03-28 14:00:00,295,153,47,23,11,35,330,118,1012
2019-03-28 15:00:00,212,82,23,11,11,35,153,11,538
2019-03-28 16:00:00,165,153,23,0,11,23,129,59,563
2019-03-28 17:00:00,236,82,11,11,11,23,70,11,455
2019-03-28 18:00:00,165,118,70,0,70,59,129,35,646
2019-03-28 19:00:00,141,47,0,0,23,23,70,82,386
2019-03-28 20:00:00,59,35,0,0,0,11,47,0,152
2019-03-28 21:00:00,35,23,0,0,11,0,35,0,104
2019-03-28 22:00:00,11,11,0,0,0,0,47,0,69
2019-03-28 23:00:00,23,11,0,0,0,0,11,0,45
2019-03-29 00:00:00,0,0,0,0,0,0,0,0,0
2019-03-29 01:00:00,0,0,0,0,0,0,11,11,22
2019-03-29 02:00:00,0,0,0,0,0,0,0,0,0
2019-03-29 03:00:00,0,0,0,0,0,11,0,0,11
2019-03-29 04:00:00,0,0,0,0,0,0,0,0,0
2019-03-29 05:00:00,11,0,0,0,0,0,0,0,11
2019-03-29 06:00:00,35,0,0,0,0,11,35,0,81
2019-03-29 07:00:00,94,11,0,11,0,0,23,47,186
2019-03-29 08:00:00,129,23,0,11,11,0,35,82,291
2019-03-29 09:00:00,59,23,0,11,23,11,59,35,221
2019-03-29 10:00:00,70,59,11,11,0,23,59,47,280
2019-03-29 11:00:00,177,106,47,11,11,11,129,47,539
2019-03-29 12:00:00,236,23,11,23,70,118,177,70,728
2019-03-29 13:00:00,129,47,23,11,35,59,247,59,610
2019-03-29 14:00:00,70,35,35,11,35,11,271,47,515
2019-03-29 15:00:00,129,35,47,11,35,23,94,70,444
2019-03-29 16:00:00,118,23,11,11,35,23,141,35,397
2019-03-29 17:00:00,47,70,0,0,11,11,47,0,186
2019-03-29 18:00:00,35,35,23,0,11,11,59,0,174
2019-03-29 19:00:00,11,35,11,11,0,23,23,11,125
2019-03-29 20:00:00,35,11,0,0,0,0,70,11,127
2019-03-29 21:00:00,11,23,0,0,23,11,11,0,79
2019-03-29 22:00:00,35,11,0,0,0,11,11,0,68
2019-03-29 23:00:00,11,11,0,0,0,0,35,0,57
2019-03-30 00:00:00,35,0,0,0,0,11,0,0,46
2019-03-30 01:00:00,23,0,0,0,0,35,11,0,69
2019-03-30 02:00:00,0,23,0,0,11,0,47,0,81
2019-03-30 03:00:00,11,0,0,0,0,0,23,11,45
2019-03-30 04:00:00,0,0,0,0,0,0,35,0,35
2019-03-30 05:00:00,0,0,0,0,0,0,35,0,35
2019-03-30 06:00:00,0,0,0,0,0,0,11,0,11
2019-03-30 07:00:00,11,0,11,0,0,0,11,0,33
2019-03-30 08:00:00,11,0,0,0,0,0,0,0,11
2019-03-30 09:00:00,47,47,0,0,23,0,59,11,187
2019-03-30 10:00:00,59,35,0,11,47,82,23,0,257
2019-03-30 11:00:00,106,236,0,11,35,106,212,23,729
2019-03-30 12:00:00,165,200,0,11,59,47,413,11,906
2019-03-30 13:00:00,236,118,0,11,70,165,389,11,1000
2019-03-30 14:00:00,177,224,0,23,59,35,247,11,776
2019-03-30 15:00:00,47,59,11,0,11,0,165,11,304
2019-03-30 16:00:00,47,35,0,0,35,35,70,11,233
2019-03-30 17:00:00,70,11,0,0,23,23,59,0,186
2019-03-30 18:00:00,106,11,0,11,0,11,35,11,185
2019-03-30 19:00:00,23,0,11,0,11,11,11,35,102
2019-03-30 20:00:00,0,11,0,0,0,0,0,0,11
2019-03-30 21:00:00,0,0,0,0,0,0,23,0,23
2019-03-30 22:00:00,0,0,0,0,0,0,0,0,0
2019-03-30 23:00:00,11,0,0,0,0,0,11,0,22
2019-03-31 00:00:00,0,0,0,0,0,0,35,0,35
2019-03-31 01:00:00,0,0,0,0,0,0,23,0,23
2019-03-31 02:00:00,0,0,0,0,0,0,0,0,0
2019-03-31 03:00:00,0,0,0,0,0,0,23,0,23
2019-03-31 04:00:00,0,0,0,0,0,0,23,0,23
2019-03-31 05:00:00,0,0,0,0,0,0,23,0,23
2019-03-31 06:00:00,0,0,0,0,0,0,29,0,29
2019-03-31 07:00:00,0,0,0,0,0,0,23,0,23
2019-03-31 08:00:00,0,11,0,0,0,0,23,0,34
2019-03-31 09:00:00,0,11,0,0,0,0,35,0,46
2019-03-31 10:00:00,0,0,0,0,0,0,41,0,41
2019-03-31 11:00:00,0,0,0,0,0,0,53,0,53
2019-03-31 12:00:00,0,0,0,0,0,0,123,0,123
2019-03-31 13:00:00,0,0,0,0,0,0,312,0,312
2019-03-31 14:00:00,0,11,0,0,0,11,359,0,381
2019-03-31 15:00:00,0,11,0,0,0,0,341,0,352
2019-03-31 16:00:00,0,23,0,0,0,0,212,0,235
2019-03-31 17:00:00,35,35,0,0,0,0,123,0,193
2019-03-31 18:00:00,23,11,0,0,0,0,100,0,134
2019-03-31 19:00:00,0,35,0,0,0,11,53,0,99
2019-03-31 20:00:00,0,11,0,0,0,11,35,0,57
2019-03-31 21:00:00,0,11,0,0,0,0,23,0,34
2019-03-31 22:00:00,0,0,0,0,0,0,11,0,11
2019-03-31 23:00:00,0,0,0,0,0,0,17,0,17
2019-04-01 00:00:00,0,0,0,0,0,0,17,0,17
2019-04-01 01:00:00,0,0,0,0,0,0,11,0,11
2019-04-01 02:00:00,0,0,0,0,0,0,11,0,11
2019-04-01 03:00:00,0,0,0,0,0,0,11,0,11
2019-04-01 04:00:00,0,0,0,0,0,0,23,0,23
2019-04-01 05:00:00,0,0,0,0,0,0,11,0,11
2019-04-01 06:00:00,0,0,0,0,0,0,23,0,23
2019-04-01 07:00:00,0,0,0,0,0,0,23,0,23
2019-04-01 08:00:00,0,0,0,0,0,0,35,0,35
2019-04-01 09:00:00,0,0,0,0,0,0,35,0,35
2019-04-01 10:00:00,0,0,0,0,0,0,53,0,53
2019-04-01 11:00:00,0,0,0,0,0,0,59,0,59
2019-04-01 12:00:00,0,0,0,0,0,0,88,0,88
2019-04-01 13:00:00,0,0,0,0,0,0,100,0,100
2019-04-01 14:00:00,708,342,118,118,82,200,123,295,1986
2019-04-01 15:00:00,908,153,94,11,0,70,135,129,1500
2019-04-01 16:00:00,401,200,0,94,106,153,88,70,1112
2019-04-01 17:00:00,200,129,0,106,59,11,82,0,587
2019-04-01 18:00:00,188,70,23,0,35,59,64,70,509
2019-04-01 19:00:00,200,23,11,11,0,11,59,0,315
2019-04-01 20:00:00,47,47,0,0,11,23,41,0,169
2019-04-01 21:00:00,94,0,0,0,0,0,11,11,116
2019-04-01 22:00:00,0,0,0,0,0,0,23,0,23
2019-04-01 23:00:00,0,23,0,0,0,0,11,0,34
2019-04-02 00:00:00,11,0,0,0,0,0,23,0,34
2019-04-02 01:00:00,0,11,0,0,0,23,11,11,56
2019-04-02 02:00:00,0,11,0,0,0,0,11,0,22
2019-04-02 03:00:00,0,11,0,0,0,0,23,0,34
2019-04-02 04:00:00,0,11,11,0,0,0,23,0,45
2019-04-02 05:00:00,11,11,23,0,0,0,11,0,56
2019-04-02 06:00:00,82,11,11,0,0,0,17,11,132
2019-04-02 07:00:00,165,94,47,0,0,0,17,23,346
2019-04-02 08:00:00,82,11,35,0,0,11,35,59,233
2019-04-02 09:00:00,82,23,23,0,0,0,47,59,234
2019-04-02 10:00:00,94,47,35,0,11,23,41,11,262
2019-04-02 11:00:00,177,94,35,23,23,23,94,23,492
2019-04-02 12:00:00,153,82,11,23,11,23,141,47,491
2019-04-02 13:00:00,188,35,70,0,0,59,147,70,569
2019-04-02 14:00:00,413,153,23,47,47,70,176,47,976
2019-04-02 15:00:00,200,59,35,11,11,47,165,11,539
2019-04-02 16:00:00,70,70,70,35,23,0,94,35,397
2019-04-02 17:00:00,70,35,47,23,59,23,64,11,332
2019-04-02 18:00:00,59,47,11,23,35,23,70,70,338
2019-04-02 19:00:00,59,23,0,0,11,23,59,11,186
2019-04-02 20:00:00,70,0,11,11,0,11,47,0,150
2019-04-02 21:00:00,35,11,0,11,11,11,35,11,125
2019-04-02 22:00:00,11,0,0,0,0,11,29,11,62
2019-04-02 23:00:00,0,0,0,0,0,0,11,0,11
2019-04-03 00:00:00,0,0,0,0,0,0,29,11,40
2019-04-03 01:00:00,23,0,0,0,0,0,0,11,34
2019-04-03 02:00:00,0,0,23,0,0,0,11,0,34
2019-04-03 03:00:00,0,0,35,0,0,0,0,0,35
2019-04-03 04:00:00,0,0,23,0,0,0,0,0,23
2019-04-03 05:00:00,0,0,35,0,0,0,23,11,69
2019-04-03 06:00:00,35,82,35,11,23,23,11,23,243
2019-04-03 07:00:00,94,0,11,23,0,11,94,70,303
2019-04-03 08:00:00,118,47,23,0,0,0,70,94,352
2019-04-03 09:00:00,82,82,35,23,47,11,70,47,397
2019-04-03 10:00:00,70,11,35,11,11,0,82,47,267
2019-04-03 11:00:00,153,47,35,47,23,23,129,59,516
2019-04-03 12:00:00,70,11,11,0,23,106,82,35,338
2019-04-03 13:00:00,212,23,11,0,11,23,106,35,421
2019-04-03 14:00:00,247,82,35,0,0,35,106,47,552
2019-04-03 15:00:00,106,23,59,0,47,35,94,70,434
2019-04-03 16:00:00,94,47,23,23,11,11,118,23,350
2019-04-03 17:00:00,35,141,11,11,11,82,59,23,373
2019-04-03 18:00:00,59,59,70,11,11,0,70,11,291
2019-04-03 19:00:00,94,47,11,0,23,11,94,35,315
2019-04-03 20:00:00,94,141,0,23,0,23,35,11,327
2019-04-03 21:00:00,11,11,0,0,0,11,47,11,91
2019-04-03 22:00:00,11,0,0,0,0,23,35,0,69
2019-04-03 23:00:00,11,0,0,11,0,0,70,0,92
2019-04-04 00:00:00,11,0,0,0,0,0,0,0,11
2019-04-04 01:00:00,0,0,0,0,0,0,0,0,0
2019-04-04 02:00:00,0,0,0,0,0,0,11,0,11
2019-04-04 03:00:00,11,0,0,0,0,0,0,0,11
2019-04-04 04:00:00,0,0,0,0,0,0,11,0,11
2019-04-04 05:00:00,11,0,0,0,0,0,23,11,45
2019-04-04 06:00:00,82,11,0,0,0,0,11,11,115
2019-04-04 07:00:00,47,11,11,0,0,0,106,23,198
2019-04-04 08:00:00,70,59,23,0,11,0,47,129,339
2019-04-04 09:00:00,47,47,23,11,0,23,70,35,256
2019-04-04 10:00:00,70,82,59,11,23,11,59,59,374
2019-04-04 11:00:00,118,47,11,23,11,82,200,35,527
2019-04-04 12:00:00,141,59,35,11,59,70,330,59,764
2019-04-04 13:00:00,177,47,47,0,47,82,542,94,1036
2019-04-04 14:00:00,342,129,35,11,118,70,2147,82,2934
2019-04-04 15:00:00,271,106,0,11,47,47,165,70,717
2019-04-04 16:00:00,82,59,0,11,35,70,118,11,386
2019-04-04 17:00:00,118,23,11,0,23,23,47,23,268
2019-04-04 18:00:00,106,70,0,11,35,47,59,118,446
2019-04-04 19:00:00,106,106,0,0,47,59,23,70,411
2019-04-04 20:00:00,129,23,11,23,11,23,47,35,302
2019-04-04 21:00:00,35,0,0,0,11,23,11,11,91
2019-04-04 22:00:00,23,23,0,0,0,23,11,23,103
2019-04-04 23:00:00,11,11,0,0,11,0,11,0,44
2019-04-05 00:00:00,23,0,0,0,0,0,0,0,23
2019-04-05 01:00:00,0,0,0,0,0,0,0,0,0
2019-04-05 02:00:00,0,0,0,0,0,0,0,0,0
2019-04-05 03:00:00,0,0,0,0,0,11,0,0,11
2019-04-05 04:00:00,0,0,0,0,0,0,0,0,0
2019-04-05 05:00:00,0,0,0,0,0,0,0,0,0
2019-04-05 06:00:00,11,11,0,0,0,0,11,11,44
2019-04-05 07:00:00,59,11,11,11,0,0,59,11,162
2019-04-05 08:00:00,129,23,11,0,0,23,11,118,315
2019-04-05 09:00:00,82,35,35,0,0,11,47,11,221
2019-04-05 10:00:00,59,59,11,23,11,11,70,35,279
2019-04-05 11:00:00,82,82,35,0,11,11,224,47,492
2019-04-05 12:00:00,118,118,70,0,0,11,283,11,611
2019-04-05 13:00:00,82,47,11,11,23,70,259,23,526
2019-04-05 14:00:00,342,82,23,0,11,23,129,59,669
2019-04-05 15:00:00,259,129,23,23,47,106,141,11,739
2019-04-05 16:00:00,165,767,35,0,0,11,141,35,1154
2019-04-05 17:00:00,11,23,0,0,23,23,59,35,174
2019-04-05 18:00:00,11,0,0,0,0,0,11,0,22
2019-04-05 19:00:00,35,23,0,0,0,11,35,0,104
2019-04-05 20:00:00,11,0,0,0,0,23,11,11,56
2019-04-05 21:00:00,0,23,0,0,0,0,11,0,34
2019-04-05 22:00:00,0,0,0,0,0,0,0,0,0
2019-04-05 23:00:00,0,0,0,0,0,0,0,0,0
2019-04-06 00:00:00,47,0,0,0,0,35,0,0,82
2019-04-06 01:00:00,23,11,0,11,11,23,0,0,79
2019-04-06 02:00:00,0,11,0,11,0,11,11,23,67
2019-04-06 03:00:00,0,0,0,0,0,0,0,0,0
2019-04-06 04:00:00,0,0,0,0,0,0,0,0,0
2019-04-06 05:00:00,0,0,0,0,0,0,0,0,0
2019-04-06 06:00:00,11,11,0,0,11,0,11,0,44
2019-04-06 07:00:00,11,0,23,0,0,0,11,0,45
2019-04-06 08:00:00,23,0,0,23,0,0,59,11,116
2019-04-06 09:00:00,59,35,0,94,11,11,23,35,268
2019-04-06 10:00:00,94,70,0,106,11,165,295,11,752
2019-04-06 11:00:00,271,177,0,129,35,306,236,70,1224
2019-04-06 12:00:00,306,354,23,200,59,354,554,70,1920
2019-04-06 13:00:00,401,295,47,436,59,247,719,47,2251
2019-04-06 14:00:00,295,259,11,259,70,283,1085,70,2332
2019-04-06 15:00:00,330,212,47,153,70,259,531,82,1684
2019-04-06 16:00:00,306,153,0,0,47,165,224,47,942
2019-04-06 17:00:00,200,188,0,35,35,94,224,118,894
2019-04-06 18:00:00,188,47,0,11,47,106,129,59,587
2019-04-06 19:00:00,165,94,35,11,23,118,141,94,681
2019-04-06 20:00:00,59,59,0,11,0,82,59,35,305
2019-04-06 21:00:00,47,0,11,0,23,23,70,11,185
2019-04-06 22:00:00,11,0,11,0,35,23,23,11,114
2019-04-06 23:00:00,23,0,0,0,0,23,70,0,116
2019-04-07 00:00:00,35,0,0,0,11,11,35,11,103
2019-04-07 01:00:00,11,0,0,0,0,11,11,82,115
2019-04-07 02:00:00,11,0,0,0,0,0,23,0,34
2019-04-07 03:00:00,0,0,0,0,0,0,0,0,0
2019-04-07 04:00:00,0,0,11,0,0,0,0,0,11
2019-04-07 05:00:00,0,0,11,0,0,0,0,11,22
2019-04-07 06:00:00,0,0,11,0,0,0,0,0,11
2019-04-07 07:00:00,0,0,23,0,0,0,11,0,34
2019-04-07 08:00:00,0,11,11,11,0,0,23,23,79
2019-04-07 09:00:00,47,11,0,0,0,11,59,11,139
2019-04-07 10:00:00,82,94,0,11,11,47,82,0,327
2019-04-07 11:00:00,141,94,11,11,23,59,507,23,869
2019-04-07 12:00:00,389,247,23,23,129,507,861,47,2226
2019-04-07 13:00:00,460,365,11,118,106,507,826,35,2428
2019-04-07 14:00:00,342,365,0,35,106,306,908,59,2121
2019-04-07 15:00:00,306,236,11,11,82,247,424,47,1364
2019-04-07 16:00:00,224,153,0,0,35,94,554,94,1154
2019-04-07 17:00:00,224,106,11,11,47,59,141,35,634
2019-04-07 18:00:00,59,23,0,0,47,47,47,23,246
2019-04-07 19:00:00,47,11,0,0,11,0,47,23,139
2019-04-07 20:00:00,11,11,0,0,0,11,35,0,68
2019-04-07 21:00:00,0,0,0,0,0,0,35,0,35
2019-04-07 22:00:00,0,0,0,0,0,0,11,0,11
2019-04-07 23:00:00,0,0,0,0,0,0,23,0,23
2019-04-08 00:00:00,0,0,0,0,0,0,11,0,11
2019-04-08 01:00:00,0,0,0,0,0,0,0,0,0
2019-04-08 02:00:00,0,0,0,0,0,0,0,0,0
2019-04-08 03:00:00,0,0,0,11,0,0,11,0,22
2019-04-08 04:00:00,0,0,0,0,0,0,0,0,0
2019-04-08 05:00:00,0,0,0,0,0,0,0,0,0
2019-04-08 06:00:00,47,11,0,11,0,0,0,11,80
2019-04-08 07:00:00,23,23,23,0,11,0,23,23,126
2019-04-08 08:00:00,129,47,35,0,11,35,23,82,362
2019-04-08 09:00:00,165,47,11,11,11,11,35,11,302
2019-04-08 10:00:00,47,59,23,0,23,11,106,47,316
2019-04-08 11:00:00,129,70,35,0,11,11,94,59,409
2019-04-08 12:00:00,70,11,11,35,11,0,70,47,255
2019-04-08 13:00:00,129,47,47,11,35,35,70,70,444
2019-04-08 14:00:00,271,11,47,0,23,47,165,94,658
2019-04-08 15:00:00,165,47,59,23,0,47,200,82,623
2019-04-08 16:00:00,200,70,47,0,11,11,118,59,516
2019-04-08 17:00:00,188,82,23,0,47,23,47,11,421
2019-04-08 18:00:00,35,35,0,0,0,35,23,0,128
2019-04-08 19:00:00,70,47,0,0,35,59,82,11,304
2019-04-08 20:00:00,35,35,0,0,11,23,23,11,138
2019-04-08 21:00:00,0,23,0,0,23,0,47,0,93
2019-04-08 22:00:00,11,11,0,0,23,0,23,0,68
2019-04-08 23:00:00,0,11,0,0,0,0,23,0,34
2019-04-09 00:00:00,11,0,0,11,0,11,0,0,33
2019-04-09 01:00:00,0,11,0,0,0,0,11,0,22
2019-04-09 02:00:00,0,0,0,0,0,0,0,0,0
2019-04-09 03:00:00,0,0,0,0,0,0,23,0,23
2019-04-09 04:00:00,0,0,0,0,0,0,0,0,0
2019-04-09 05:00:00,23,0,0,0,0,0,11,0,34
2019-04-09 06:00:00,47,11,0,0,0,11,11,0,80
2019-04-09 07:00:00,118,47,11,0,0,11,59,35,281
2019-04-09 08:00:00,141,35,0,0,0,11,59,118,364
2019-04-09 09:00:00,94,94,59,0,23,0,94,35,399
2019-04-09 10:00:00,70,59,59,0,23,0,70,94,375
2019-04-09 11:00:00,129,35,23,11,47,47,188,35,515
2019-04-09 12:00:00,165,82,0,0,0,23,129,47,446
2019-04-09 13:00:00,236,59,47,0,11,59,129,35,576
2019-04-09 14:00:00,200,23,23,23,35,23,165,82,574
2019-04-09 15:00:00,318,59,59,35,23,70,165,70,799
2019-04-09 16:00:00,35,47,23,106,47,106,177,23,564
2019-04-09 17:00:00,259,47,11,0,11,82,94,11,515
2019-04-09 18:00:00,59,23,47,0,35,47,23,11,245
2019-04-09 19:00:00,47,23,11,0,23,47,59,0,210
2019-04-09 20:00:00,47,11,0,0,11,23,35,0,127
2019-04-09 21:00:00,23,0,0,0,11,23,47,0,104
2019-04-09 22:00:00,11,11,0,0,0,11,47,0,80
2019-04-09 23:00:00,0,0,0,0,0,0,35,0,35
2019-04-10 00:00:00,11,0,0,0,0,0,23,11,45
2019-04-10 01:00:00,23,0,0,0,0,0,23,11,57
2019-04-10 02:00:00,11,0,23,0,0,0,23,0,57
2019-04-10 03:00:00,0,0,35,0,0,0,35,0,70
2019-04-10 04:00:00,11,0,23,0,0,0,59,0,93
2019-04-10 05:00:00,11,0,35,0,0,0,23,0,69
2019-04-10 06:00:00,47,11,35,11,0,17,82,0,203
2019-04-10 07:00:00,70,11,35,0,0,0,70,47,233
2019-04-10 08:00:00,82,35,23,0,0,23,70,94,327
2019-04-10 09:00:00,59,35,23,11,11,11,59,11,220
2019-04-10 10:00:00,59,47,106,11,0,0,59,11,293
2019-04-10 11:00:00,70,47,59,0,11,35,94,35,351
2019-04-10 12:00:00,82,153,59,23,47,613,129,47,1153
2019-04-10 13:00:00,82,401,35,11,11,365,224,59,1188
2019-04-10 14:00:00,165,59,23,0,59,23,354,106,789
2019-04-10 15:00:00,129,47,23,23,11,11,188,59,491
2019-04-10 16:00:00,94,94,11,11,23,23,212,0,468
2019-04-10 17:00:00,70,47,35,23,23,23,224,11,456
2019-04-10 18:00:00,129,35,47,23,23,35,94,70,456
2019-04-10 19:00:00,94,35,11,11,47,35,70,23,326
2019-04-10 20:00:00,35,11,23,17,35,200,35,11,367
2019-04-10 21:00:00,23,0,0,11,0,11,0,23,68
2019-04-10 22:00:00,11,11,0,11,0,0,23,0,56
2019-04-10 23:00:00,0,0,11,11,0,0,82,0,104
2019-04-11 00:00:00,11,0,0,0,0,0,11,0,22
2019-04-11 01:00:00,11,0,0,0,0,0,0,0,11
2019-04-11 02:00:00,0,0,0,0,0,0,11,0,11
2019-04-11 03:00:00,0,0,0,0,0,0,11,0,11
2019-04-11 04:00:00,0,0,0,0,0,0,11,0,11
2019-04-11 05:00:00,0,0,0,0,0,0,11,0,11
2019-04-11 06:00:00,35,23,0,0,0,11,23,0,92
2019-04-11 07:00:00,106,23,11,0,0,0,47,47,234
2019-04-11 08:00:00,141,23,0,0,23,11,59,70,327
2019-04-11 09:00:00,23,0,0,11,23,11,11,23,102
2019-04-11 10:00:00,59,23,23,0,23,23,118,59,328
2019-04-11 11:00:00,259,82,11,11,35,47,247,11,703
2019-04-11 12:00:00,106,47,11,0,23,11,141,47,386
2019-04-11 13:00:00,212,94,0,23,23,0,106,35,493
2019-04-11 14:00:00,118,70,106,23,0,35,141,70,563
2019-04-11 15:00:00,153,59,94,0,0,35,306,0,647
2019-04-11 16:00:00,94,35,11,23,35,23,70,11,302
2019-04-11 17:00:00,11,23,0,23,35,23,141,0,256
2019-04-11 18:00:00,129,23,11,0,35,23,118,35,374
2019-04-11 19:00:00,47,70,0,23,35,82,153,23,433
2019-04-11 20:00:00,70,70,0,11,11,35,82,0,279
2019-04-11 21:00:00,47,11,0,11,35,11,23,0,138
2019-04-11 22:00:00,59,0,11,0,11,23,11,0,115
2019-04-11 23:00:00,11,0,0,0,0,0,0,0,11
2019-04-12 00:00:00,0,0,0,0,0,0,23,0,23
2019-04-12 01:00:00,0,0,0,0,0,0,0,0,0
2019-04-12 02:00:00,0,11,0,0,0,0,11,0,22
2019-04-12 03:00:00,0,0,0,0,0,0,35,0,35
2019-04-12 04:00:00,0,11,0,0,0,0,23,0,34
2019-04-12 05:00:00,0,0,0,0,0,0,11,0,11
2019-04-12 06:00:00,23,0,0,0,0,0,47,0,70
2019-04-12 07:00:00,118,23,35,0,0,0,82,35,293
2019-04-12 08:00:00,94,35,35,11,11,0,23,118,327
2019-04-12 09:00:00,47,0,23,0,59,11,0,11,151
2019-04-12 10:00:00,70,106,47,0,47,23,59,59,411
2019-04-12 11:00:00,129,106,11,0,70,35,165,0,516
2019-04-12 12:00:00,165,70,23,0,35,59,188,0,540
2019-04-12 13:00:00,247,106,11,11,35,59,259,0,728
2019-04-12 14:00:00,106,70,23,11,59,70,259,0,598
2019-04-12 15:00:00,177,23,23,11,11,59,342,0,646
2019-04-12 16:00:00,118,47,23,11,23,70,200,0,492
2019-04-12 17:00:00,165,23,0,0,11,11,59,35,304
2019-04-12 18:00:00,47,59,0,0,23,47,94,0,270
2019-04-12 19:00:00,94,35,0,0,23,59,118,23,352
2019-04-12 20:00:00,70,11,0,11,0,23,70,35,220
2019-04-12 21:00:00,59,23,0,0,11,0,35,23,151
2019-04-12 22:00:00,35,11,0,0,0,35,82,11,174
2019-04-12 23:00:00,0,0,0,0,0,11,94,0,105
2019-04-13 00:00:00,23,11,0,0,11,47,59,0,151
2019-04-13 01:00:00,0,0,0,11,0,23,0,0,34
2019-04-13 02:00:00,47,0,0,0,0,0,0,0,47
2019-04-13 03:00:00,11,0,0,0,0,11,11,0,33
2019-04-13 04:00:00,11,0,0,0,0,0,0,0,11
2019-04-13 05:00:00,11,0,0,0,0,0,11,0,22
2019-04-13 06:00:00,11,11,0,0,0,0,11,0,33
2019-04-13 07:00:00,23,23,0,0,0,0,23,0,69
2019-04-13 08:00:00,0,23,0,35,0,0,35,0,93
2019-04-13 09:00:00,11,11,0,59,0,0,82,0,163
2019-04-13 10:00:00,424,106,11,94,0,23,165,0,823
2019-04-13 11:00:00,177,153,11,129,59,389,377,23,1318
2019-04-13 12:00:00,153,365,23,259,47,236,755,59,1897
2019-04-13 13:00:00,306,330,23,318,47,224,908,70,2226
2019-04-13 14:00:00,259,578,82,165,177,365,755,23,2404
2019-04-13 15:00:00,448,342,70,59,177,483,601,82,2262
2019-04-13 16:00:00,519,436,35,23,82,200,507,35,1837
2019-04-13 17:00:00,165,35,23,11,47,153,188,70,692
2019-04-13 18:00:00,106,118,23,0,23,23,129,11,433
2019-04-13 19:00:00,82,23,11,11,11,47,35,11,231
2019-04-13 20:00:00,23,23,0,0,0,23,70,0,139
2019-04-13 21:00:00,47,23,0,11,23,0,47,0,151
2019-04-13 22:00:00,141,23,0,11,0,11,224,0,410
2019-04-13 23:00:00,23,35,0,0,0,0,70,11,139
2019-04-14 00:00:00,35,35,0,11,0,11,23,11,126
2019-04-14 01:00:00,11,23,0,0,0,0,47,0,81
2019-04-14 02:00:00,23,0,0,0,0,0,59,0,82
2019-04-14 03:00:00,0,0,0,0,0,0,11,0,11
2019-04-14 04:00:00,0,0,0,0,0,0,11,0,11
2019-04-14 05:00:00,0,0,0,0,0,0,11,0,11
2019-04-14 06:00:00,0,0,0,0,0,0,35,0,35
2019-04-14 07:00:00,0,0,0,0,0,11,11,0,22
2019-04-14 08:00:00,0,35,0,0,0,0,11,23,69
2019-04-14 09:00:00,23,35,11,0,0,0,23,0,92
2019-04-14 10:00:00,23,106,0,23,11,11,82,59,315
2019-04-14 11:00:00,177,153,23,23,11,47,165,35,634
2019-04-14 12:00:00,177,342,0,11,47,247,413,106,1343
2019-04-14 13:00:00,318,330,47,35,82,637,483,106,2038
2019-04-14 14:00:00,660,212,11,106,106,649,637,82,2463
2019-04-14 15:00:00,436,259,35,47,35,306,342,35,1495
2019-04-14 16:00:00,165,200,35,23,94,188,259,23,987
2019-04-14 17:00:00,165,82,11,11,59,35,82,11,456
2019-04-14 18:00:00,70,82,0,0,0,11,70,11,244
2019-04-14 19:00:00,35,59,23,0,23,59,82,11,292
2019-04-14 20:00:00,23,59,0,0,23,70,59,11,245
2019-04-14 21:00:00,11,11,11,0,0,23,0,0,56
2019-04-14 22:00:00,0,11,0,0,0,11,0,0,22
2019-04-14 23:00:00,0,0,0,0,0,0,11,0,11
2019-04-15 00:00:00,0,0,0,0,0,0,0,0,0
2019-04-15 01:00:00,11,0,0,0,0,0,0,0,11
2019-04-15 02:00:00,11,0,0,0,0,0,0,0,11
2019-04-15 03:00:00,0,0,0,0,0,0,11,0,11
2019-04-15 04:00:00,0,11,0,0,0,0,23,0,34
2019-04-15 05:00:00,11,0,0,0,0,0,47,0,58
2019-04-15 06:00:00,23,0,0,0,0,0,23,11,57
2019-04-15 07:00:00,0,23,0,0,0,0,70,11,104
2019-04-15 08:00:00,11,23,11,0,11,0,47,0,103
2019-04-15 09:00:00,23,23,0,11,11,35,47,11,161
2019-04-15 10:00:00,70,23,11,23,11,23,106,23,290
2019-04-15 11:00:00,70,200,35,11,35,47,448,23,869
2019-04-15 12:00:00,165,129,23,23,11,94,306,23,774
2019-04-15 13:00:00,129,342,23,82,59,70,578,11,1294
2019-04-15 14:00:00,188,141,23,23,0,59,436,23,893
2019-04-15 15:00:00,70,153,11,23,47,35,271,11,621
2019-04-15 16:00:00,212,188,11,11,59,35,236,47,799
2019-04-15 17:00:00,212,47,47,0,11,59,177,23,576
2019-04-15 18:00:00,118,82,23,0,11,47,47,23,351
2019-04-15 19:00:00,35,106,0,35,23,59,47,11,316
2019-04-15 20:00:00,59,23,11,0,0,0,47,11,151
2019-04-15 21:00:00,0,11,0,0,11,11,11,0,44
2019-04-15 22:00:00,0,0,0,0,0,0,0,0,0
2019-04-15 23:00:00,0,0,0,0,0,0,11,0,11
2019-04-16 00:00:00,11,11,0,0,0,0,11,0,33
2019-04-16 01:00:00,0,0,11,0,0,0,0,0,11
2019-04-16 02:00:00,0,11,0,0,0,0,0,0,11
2019-04-16 03:00:00,0,0,0,0,0,0,0,0,0
2019-04-16 04:00:00,0,11,0,0,0,0,11,0,22
2019-04-16 05:00:00,11,0,0,0,0,0,11,23,45
2019-04-16 06:00:00,0,11,0,0,0,0,11,11,33
2019-04-16 07:00:00,11,11,11,0,0,0,35,11,79
2019-04-16 08:00:00,23,23,0,0,0,0,70,23,139
2019-04-16 09:00:00,47,35,11,0,0,11,94,0,198
2019-04-16 10:00:00,129,35,0,11,11,35,153,47,421
2019-04-16 11:00:00,106,141,23,11,70,35,200,59,645
2019-04-16 12:00:00,118,188,23,47,35,94,236,23,764
2019-04-16 13:00:00,188,236,11,59,47,118,389,70,1118
2019-04-16 14:00:00,141,129,11,35,0,35,483,59,893
2019-04-16 15:00:00,177,70,35,59,23,70,271,35,740
2019-04-16 16:00:00,106,82,0,0,0,35,141,23,387
2019-04-16 17:00:00,129,70,0,0,11,35,82,11,338
2019-04-16 18:00:00,35,47,0,0,23,11,47,0,163
2019-04-16 19:00:00,70,59,0,0,0,23,59,11,222
2019-04-16 20:00:00,70,35,11,0,0,0,59,11,186
2019-04-16 21:00:00,23,0,11,0,11,0,59,0,104
2019-04-16 22:00:00,0,11,0,0,0,0,0,23,34
2019-04-16 23:00:00,0,0,11,0,0,0,0,0,11
2019-04-17 00:00:00,0,0,0,0,0,0,11,11,22
2019-04-17 01:00:00,0,0,0,0,0,0,11,0,11
2019-04-17 02:00:00,11,0,0,0,0,0,0,0,11
2019-04-17 03:00:00,0,0,0,0,0,0,0,0,0
2019-04-17 04:00:00,0,11,0,0,0,0,0,0,11
2019-04-17 05:00:00,11,0,0,0,0,0,0,0,11
2019-04-17 06:00:00,11,11,0,0,0,0,0,0,22
2019-04-17 07:00:00,47,23,0,0,23,0,70,23,186
2019-04-17 08:00:00,59,11,11,0,35,11,35,0,162
2019-04-17 09:00:00,59,35,0,0,11,23,94,11,233
2019-04-17 10:00:00,106,70,0,23,0,11,118,11,339
2019-04-17 11:00:00,141,129,23,23,47,70,259,23,715
2019-04-17 12:00:00,106,118,11,23,35,153,377,47,870
2019-04-17 13:00:00,165,259,23,23,59,94,542,11,1176
2019-04-17 14:00:00,141,153,0,35,35,165,1003,11,1543
2019-04-17 15:00:00,212,129,47,11,70,82,814,106,1471
2019-04-17 16:00:00,141,106,23,23,0,94,177,23,587
2019-04-17 17:00:00,47,59,0,35,11,82,188,47,469
2019-04-17 18:00:00,153,35,11,0,11,118,82,0,410
2019-04-17 19:00:00,106,70,0,11,23,35,94,35,374
2019-04-17 20:00:00,82,11,0,0,11,11,47,11,173
2019-04-17 21:00:00,35,0,0,0,0,35,82,11,163
2019-04-17 22:00:00,59,11,0,0,0,0,35,0,105
2019-04-17 23:00:00,23,0,0,0,0,0,0,0,23
2019-04-18 00:00:00,0,0,0,0,0,0,35,0,35
2019-04-18 01:00:00,0,0,0,0,0,0,11,0,11
2019-04-18 02:00:00,0,0,0,0,0,0,0,0,0
2019-04-18 03:00:00,0,0,0,0,0,0,0,0,0
2019-04-18 04:00:00,0,0,0,0,0,0,11,0,11
2019-04-18 05:00:00,0,11,0,0,0,0,0,0,11
2019-04-18 06:00:00,0,0,0,0,0,0,0,0,0
2019-04-18 07:00:00,11,0,0,0,0,0,11,0,22
2019-04-18 08:00:00,11,23,0,0,0,0,11,0,45
2019-04-18 09:00:00,11,0,11,0,0,0,47,11,80
2019-04-18 10:00:00,59,82,11,11,0,0,70,35,268
2019-04-18 11:00:00,129,141,23,23,47,35,236,11,645
2019-04-18 12:00:00,247,224,70,35,94,129,389,23,1211
2019-04-18 13:00:00,224,177,59,47,47,247,542,47,1390
2019-04-18 14:00:00,330,259,35,94,59,224,578,59,1638
2019-04-18 15:00:00,342,247,47,47,47,141,613,94,1578
2019-04-18 16:00:00,365,177,0,0,47,94,401,23,1107
2019-04-18 17:00:00,118,82,59,0,47,165,200,23,694
2019-04-18 18:00:00,153,106,11,0,35,59,59,11,434
2019-04-18 19:00:00,70,94,11,23,11,11,70,11,301
2019-04-18 20:00:00,35,82,11,11,35,70,47,23,314
2019-04-18 21:00:00,35,70,0,0,0,23,94,23,245
2019-04-18 22:00:00,59,23,0,0,23,23,59,23,210
2019-04-18 23:00:00,70,0,0,0,0,0,59,35,164
2019-04-19 00:00:00,0,0,0,0,0,0,0,0,0
2019-04-19 01:00:00,23,11,0,0,0,0,0,0,34
2019-04-19 02:00:00,0,23,0,0,0,0,11,0,34
2019-04-19 03:00:00,0,0,0,0,0,0,11,0,11
2019-04-19 04:00:00,0,0,0,0,0,0,0,0,0
2019-04-19 05:00:00,0,0,0,0,0,0,23,0,23
2019-04-19 06:00:00,0,0,0,0,0,0,23,0,23
2019-04-19 07:00:00,0,0,0,0,0,0,23,0,23
2019-04-19 08:00:00,0,23,0,0,0,0,11,11,45
2019-04-19 09:00:00,23,23,0,0,0,23,23,23,115
2019-04-19 10:00:00,129,47,11,11,0,23,70,0,291
2019-04-19 11:00:00,247,212,23,11,35,59,389,47,1023
2019-04-19 12:00:00,153,177,35,35,118,94,519,94,1225
2019-04-19 13:00:00,259,436,23,70,165,271,684,106,2014
2019-04-19 14:00:00,306,247,47,11,224,236,696,70,1837
2019-04-19 15:00:00,295,153,35,59,82,295,873,47,1839
2019-04-19 16:00:00,306,295,23,23,11,165,672,35,1530
2019-04-19 17:00:00,177,59,35,23,23,106,236,118,777
2019-04-19 18:00:00,106,141,0,0,11,82,94,0,434
2019-04-19 19:00:00,177,200,23,0,0,47,70,59,576
2019-04-19 20:00:00,35,59,0,11,23,47,165,23,363
2019-04-19 21:00:00,59,35,0,11,11,70,82,35,303
2019-04-19 22:00:00,59,23,0,0,0,23,35,23,163
2019-04-19 23:00:00,23,11,0,11,11,82,59,11,208
2019-04-20 00:00:00,11,23,0,0,11,35,11,11,102
2019-04-20 01:00:00,23,0,0,0,0,35,0,0,58
2019-04-20 02:00:00,0,0,0,0,0,0,0,0,0
2019-04-20 03:00:00,0,0,0,0,0,0,11,0,11
2019-04-20 04:00:00,0,0,0,0,0,0,0,0,0
2019-04-20 05:00:00,0,0,0,0,0,0,0,0,0
2019-04-20 06:00:00,0,0,11,0,0,0,11,0,22
2019-04-20 07:00:00,11,0,0,0,0,0,11,0,22
2019-04-20 08:00:00,23,0,0,35,11,35,11,11,126
2019-04-20 09:00:00,35,47,0,94,23,11,82,11,303
2019-04-20 10:00:00,212,59,0,177,0,47,153,11,659
2019-04-20 11:00:00,165,165,23,200,11,70,342,23,999
2019-04-20 12:00:00,330,295,23,365,295,330,955,129,2722
2019-04-20 13:00:00,365,342,11,531,106,259,2147,59,3820
2019-04-20 14:00:00,318,401,47,354,129,271,932,35,2487
2019-04-20 15:00:00,224,306,11,118,153,200,649,23,1684
2019-04-20 16:00:00,165,188,35,23,47,118,590,23,1189
2019-04-20 17:00:00,212,224,0,0,23,188,283,59,989
2019-04-20 18:00:00,118,106,11,0,35,47,118,47,482
2019-04-20 19:00:00,106,23,11,0,11,0,47,0,198
2019-04-20 20:00:00,70,35,11,0,11,11,35,11,184
2019-04-20 21:00:00,23,0,0,0,11,0,47,23,104
2019-04-20 22:00:00,35,0,0,0,0,0,23,23,81
2019-04-20 23:00:00,23,0,0,0,0,0,70,0,93
2019-04-21 00:00:00,11,0,0,0,0,0,23,0,34
2019-04-21 01:00:00,11,0,0,0,0,0,23,0,34
2019-04-21 02:00:00,0,0,0,0,0,0,0,0,0
2019-04-21 03:00:00,0,0,0,0,0,0,23,0,23
2019-04-21 04:00:00,0,0,0,0,0,0,0,0,0
2019-04-21 05:00:00,0,0,0,0,0,0,23,0,23
2019-04-21 06:00:00,0,0,0,0,0,0,35,0,35
2019-04-21 07:00:00,11,11,0,0,0,0,35,0,57
2019-04-21 08:00:00,0,0,11,0,23,11,59,11,115
2019-04-21 09:00:00,47,23,0,0,11,11,23,0,115
2019-04-21 10:00:00,35,47,0,23,11,23,106,35,280
2019-04-21 11:00:00,59,165,23,23,35,35,141,11,492
2019-04-21 12:00:00,153,259,23,59,70,153,613,59,1389
2019-04-21 13:00:00,342,472,23,59,82,153,1876,94,3101
2019-04-21 14:00:00,342,200,47,70,70,177,578,23,1507
2019-04-21 15:00:00,354,188,23,23,82,200,519,23,1412
2019-04-21 16:00:00,188,47,59,23,11,59,306,35,728
2019-04-21 17:00:00,70,141,94,23,47,129,177,47,728
2019-04-21 18:00:00,94,106,35,23,23,35,70,11,397
2019-04-21 19:00:00,35,35,35,11,0,70,106,0,292
2019-04-21 20:00:00,47,35,23,0,0,0,70,11,186
2019-04-21 21:00:00,0,0,0,0,0,0,23,0,23
2019-04-21 22:00:00,11,0,0,0,0,0,47,11,69
2019-04-21 23:00:00,0,0,0,11,0,11,0,11,33
2019-04-22 00:00:00,0,0,0,0,0,0,0,0,0
2019-04-22 01:00:00,0,0,0,0,0,0,0,0,0
2019-04-22 02:00:00,0,11,0,0,0,0,23,0,34
2019-04-22 03:00:00,0,0,0,0,0,0,0,0,0
2019-04-22 04:00:00,0,0,0,0,0,0,0,0,0
2019-04-22 05:00:00,0,0,0,0,0,0,0,0,0
2019-04-22 06:00:00,0,0,0,0,0,0,0,0,0
2019-04-22 07:00:00,0,0,0,0,0,0,11,0,11
2019-04-22 08:00:00,0,23,0,0,0,11,0,11,45
2019-04-22 09:00:00,11,0,0,0,11,11,11,0,44
2019-04-22 10:00:00,23,153,11,11,0,35,82,35,350
2019-04-22 11:00:00,35,212,0,11,35,59,200,47,599
2019-04-22 12:00:00,153,224,35,59,70,59,566,23,1189
2019-04-22 13:00:00,188,306,70,11,59,165,625,106,1530
2019-04-22 14:00:00,236,200,35,82,129,141,684,35,1542
2019-04-22 15:00:00,330,236,23,82,82,165,625,82,1625
2019-04-22 16:00:00,153,129,0,0,59,70,259,11,681
2019-04-22 17:00:00,188,35,11,0,0,70,94,59,457
2019-04-22 18:00:00,188,47,11,11,35,59,59,11,421
2019-04-22 19:00:00,35,59,11,0,11,35,35,0,186
2019-04-22 20:00:00,70,82,0,0,0,0,35,47,234
2019-04-22 21:00:00,23,0,0,0,0,11,0,0,34
2019-04-22 22:00:00,11,23,11,0,0,23,23,11,102
2019-04-22 23:00:00,0,0,0,0,11,0,23,0,34
2019-04-23 00:00:00,0,0,0,0,0,0,0,0,0
2019-04-23 01:00:00,0,11,0,0,11,11,23,11,67
2019-04-23 02:00:00,0,0,0,0,0,11,11,0,22
2019-04-23 03:00:00,0,0,0,0,0,0,0,0,0
2019-04-23 04:00:00,0,0,0,0,0,0,0,0,0
2019-04-23 05:00:00,11,11,0,0,0,0,11,0,33
2019-04-23 06:00:00,35,0,0,0,0,0,47,0,82
2019-04-23 07:00:00,118,11,11,0,0,11,47,47,245
2019-04-23 08:00:00,106,59,23,0,11,11,23,188,421
2019-04-23 09:00:00,47,47,11,11,47,11,59,0,233
2019-04-23 10:00:00,47,59,11,11,11,47,70,35,291
2019-04-23 11:00:00,94,82,47,11,23,59,141,35,492
2019-04-23 12:00:00,153,11,11,35,23,11,200,70,514
2019-04-23 13:00:00,94,59,70,11,35,35,188,35,527
2019-04-23 14:00:00,177,82,23,35,70,47,153,129,716
2019-04-23 15:00:00,188,59,59,0,11,35,165,0,517
2019-04-23 16:00:00,94,59,23,11,0,11,153,47,398
2019-04-23 17:00:00,70,94,23,0,11,59,118,59,434
2019-04-23 18:00:00,141,11,70,0,47,47,118,35,469
2019-04-23 19:00:00,82,94,0,0,47,59,47,11,340
2019-04-23 20:00:00,23,70,35,0,47,35,70,23,303
2019-04-23 21:00:00,35,23,23,0,11,11,35,0,138
2019-04-23 22:00:00,11,0,23,0,0,0,47,0,81
2019-04-23 23:00:00,11,11,0,0,11,0,23,11,67
2019-04-24 00:00:00,0,11,0,0,0,11,11,11,44
2019-04-24 01:00:00,0,0,0,0,0,0,23,0,23
2019-04-24 02:00:00,0,11,0,0,0,0,23,0,34
2019-04-24 03:00:00,0,0,0,0,0,0,11,0,11
2019-04-24 04:00:00,0,0,0,0,0,0,0,0,0
2019-04-24 05:00:00,0,0,0,0,0,0,0,0,0
2019-04-24 06:00:00,23,23,0,0,0,0,23,23,92
2019-04-24 07:00:00,106,23,23,23,0,0,35,23,233
2019-04-24 08:00:00,82,70,11,0,11,11,35,70,290
2019-04-24 09:00:00,94,70,0,0,82,35,47,35,363
2019-04-24 10:00:00,47,35,11,35,35,70,59,23,315
2019-04-24 11:00:00,141,141,11,23,23,23,295,47,704
2019-04-24 12:00:00,70,59,0,0,35,23,283,82,552
2019-04-24 13:00:00,448,118,35,0,23,47,165,82,918
2019-04-24 14:00:00,177,35,0,35,59,47,177,94,624
2019-04-24 15:00:00,188,70,23,0,23,11,106,47,468
2019-04-24 16:00:00,70,59,0,11,11,35,82,11,279
2019-04-24 17:00:00,59,23,11,0,0,0,106,11,210
2019-04-24 18:00:00,70,11,11,11,11,35,94,11,254
2019-04-24 19:00:00,94,11,23,0,11,11,70,11,231
2019-04-24 20:00:00,11,23,11,0,11,23,23,23,125
2019-04-24 21:00:00,23,11,0,0,11,23,47,23,138
2019-04-24 22:00:00,23,11,0,0,11,47,47,23,162
2019-04-24 23:00:00,0,0,0,11,0,11,11,0,33
2019-04-25 00:00:00,0,0,0,0,0,0,11,0,11
2019-04-25 01:00:00,0,0,0,0,0,0,11,0,11
2019-04-25 02:00:00,0,0,0,0,0,0,35,0,35
2019-04-25 03:00:00,0,0,0,0,0,11,11,0,22
2019-04-25 04:00:00,0,0,0,0,0,0,11,0,11
2019-04-25 05:00:00,11,0,0,0,0,0,11,0,22
2019-04-25 06:00:00,47,23,11,0,0,0,35,23,139
2019-04-25 07:00:00,47,23,0,11,0,0,23,0,104
2019-04-25 08:00:00,106,11,11,0,0,0,35,35,198
2019-04-25 09:00:00,35,82,23,0,35,23,35,11,244
2019-04-25 10:00:00,82,11,23,0,23,35,118,82,374
2019-04-25 11:00:00,82,59,23,0,23,0,177,35,399
2019-04-25 12:00:00,165,47,23,0,23,47,271,106,682
2019-04-25 13:00:00,212,35,35,11,35,23,200,59,610
2019-04-25 14:00:00,283,106,94,35,59,11,247,35,870
2019-04-25 15:00:00,177,82,23,0,23,70,200,47,622
2019-04-25 16:00:00,106,35,11,11,0,35,188,11,397
2019-04-25 17:00:00,59,59,0,0,0,11,47,35,211
2019-04-25 18:00:00,177,35,0,11,23,0,47,23,316
2019-04-25 19:00:00,82,106,0,23,47,47,35,11,351
2019-04-25 20:00:00,118,35,11,23,11,0,47,0,245
2019-04-25 21:00:00,11,11,0,0,11,11,47,0,91
2019-04-25 22:00:00,11,11,0,11,11,0,0,11,55
2019-04-25 23:00:00,0,0,23,0,0,0,23,0,46
2019-04-26 00:00:00,11,0,0,0,0,0,11,0,22
2019-04-26 01:00:00,0,0,0,0,0,0,0,0,0
2019-04-26 02:00:00,0,0,0,0,0,0,0,0,0
2019-04-26 03:00:00,11,0,0,0,0,11,0,0,22
2019-04-26 04:00:00,0,0,0,0,0,0,0,0,0
2019-04-26 05:00:00,0,0,0,0,0,0,11,0,11
2019-04-26 06:00:00,35,11,0,0,0,0,23,0,69
2019-04-26 07:00:00,118,23,0,0,0,0,47,0,188
2019-04-26 08:00:00,59,70,23,0,0,0,23,0,175
2019-04-26 09:00:00,82,70,35,23,47,35,35,0,327
2019-04-26 10:00:00,59,35,11,0,11,11,153,0,280
2019-04-26 11:00:00,118,23,47,11,11,35,165,0,410
2019-04-26 12:00:00,47,82,35,0,35,59,259,0,517
2019-04-26 13:00:00,0,59,11,11,11,94,212,0,398
2019-04-26 14:00:00,0,82,35,0,35,35,0,0,187
2019-04-26 15:00:00,188,118,0,0,47,35,59,0,447
2019-04-26 16:00:00,177,47,35,0,11,59,177,0,506
2019-04-26 17:00:00,129,70,11,35,0,11,82,0,338
2019-04-26 18:00:00,141,59,11,11,47,35,118,0,422
2019-04-26 19:00:00,436,82,11,153,47,23,365,0,1117
2019-04-26 20:00:00,47,47,0,0,11,35,94,0,234
2019-04-26 21:00:00,177,23,0,23,47,23,118,0,411
2019-04-26 22:00:00,106,35,11,35,23,106,200,0,516
2019-04-26 23:00:00,59,23,11,35,11,106,47,0,292
2019-04-27 00:00:00,35,0,11,0,0,70,23,0,139
2019-04-27 01:00:00,35,0,0,0,11,11,0,0,57
2019-04-27 02:00:00,11,0,0,0,11,0,11,0,33
2019-04-27 03:00:00,0,0,11,0,0,0,0,0,11
2019-04-27 04:00:00,0,0,0,0,0,0,11,0,11
2019-04-27 05:00:00,0,0,0,0,0,0,11,0,11
2019-04-27 06:00:00,11,0,0,0,0,0,23,0,34
2019-04-27 07:00:00,11,0,0,0,0,0,11,11,33
2019-04-27 08:00:00,23,35,11,23,11,0,47,0,150
2019-04-27 09:00:00,47,153,0,23,0,0,129,11,363
2019-04-27 10:00:00,82,94,11,106,0,35,224,11,563
2019-04-27 11:00:00,271,236,23,141,59,82,377,35,1224
2019-04-27 12:00:00,247,295,47,259,35,236,896,94,2109
2019-04-27 13:00:00,613,212,35,236,118,212,778,47,2251
2019-04-27 14:00:00,365,295,11,212,94,247,790,23,2037
2019-04-27 15:00:00,306,82,23,94,47,177,578,11,1318
2019-04-27 16:00:00,271,259,0,0,23,118,696,11,1378
2019-04-27 17:00:00,188,47,23,47,23,94,141,23,586
2019-04-27 18:00:00,224,165,11,11,0,35,129,11,586
2019-04-27 19:00:00,23,11,0,11,23,11,153,0,232
2019-04-27 20:00:00,35,0,11,0,0,11,129,23,209
2019-04-27 21:00:00,129,35,0,11,0,47,129,0,351
2019-04-27 22:00:00,23,11,0,0,0,0,94,0,128
2019-04-27 23:00:00,23,11,11,11,0,0,82,0,138
2019-04-28 00:00:00,129,0,0,0,11,0,82,11,233
2019-04-28 01:00:00,11,11,0,0,0,0,0,0,22
2019-04-28 02:00:00,0,11,0,0,0,11,11,0,33
2019-04-28 03:00:00,0,0,11,0,0,0,0,0,11
2019-04-28 04:00:00,0,0,0,0,0,0,0,0,0
2019-04-28 05:00:00,0,0,0,0,0,0,0,0,0
2019-04-28 06:00:00,0,0,0,0,0,0,0,0,0
2019-04-28 07:00:00,11,0,0,0,0,0,0,0,11
2019-04-28 08:00:00,23,23,0,0,0,11,0,11,68
2019-04-28 09:00:00,35,35,47,0,11,11,23,11,173
2019-04-28 10:00:00,35,23,23,0,11,23,47,0,162
2019-04-28 11:00:00,82,47,59,11,35,94,177,0,505
2019-04-28 12:00:00,224,224,23,11,82,200,330,94,1188
2019-04-28 13:00:00,295,188,35,35,129,212,908,59,1861
2019-04-28 14:00:00,389,413,59,59,153,342,767,106,2288
2019-04-28 15:00:00,212,224,70,35,94,259,354,0,1248
2019-04-28 16:00:00,212,106,23,11,153,247,283,70,1105
2019-04-28 17:00:00,236,82,35,23,11,165,330,0,882
2019-04-28 18:00:00,129,59,23,35,23,141,153,11,574
2019-04-28 19:00:00,82,70,0,0,23,82,247,0,504
2019-04-28 20:00:00,35,23,0,0,11,11,35,11,126
2019-04-28 21:00:00,94,23,0,0,35,47,0,23,222
2019-04-28 22:00:00,11,11,0,0,0,0,11,0,33
2019-04-28 23:00:00,0,11,11,0,0,0,0,0,22
2019-04-29 00:00:00,0,23,0,0,23,0,0,0,46
2019-04-29 01:00:00,11,0,0,0,0,11,11,11,44
2019-04-29 02:00:00,0,0,0,0,0,0,0,0,0
2019-04-29 03:00:00,0,0,0,0,0,0,0,0,0
2019-04-29 04:00:00,0,0,0,0,0,0,11,0,11
2019-04-29 05:00:00,23,0,0,0,0,0,0,0,23
2019-04-29 06:00:00,59,11,0,0,0,0,11,11,92
2019-04-29 07:00:00,59,35,0,0,0,0,59,82,235
2019-04-29 08:00:00,141,59,11,0,35,11,94,82,433
2019-04-29 09:00:00,70,94,23,11,0,11,70,23,302
2019-04-29 10:00:00,47,82,35,11,0,82,94,0,351
2019-04-29 11:00:00,106,94,23,47,23,35,141,0,469
2019-04-29 12:00:00,200,59,11,11,11,70,224,59,645
2019-04-29 13:00:00,106,118,59,11,47,35,224,23,623
2019-04-29 14:00:00,188,94,11,47,35,94,318,224,1011
2019-04-29 15:00:00,153,82,59,0,0,59,129,35,517
2019-04-29 16:00:00,141,23,11,0,11,11,247,35,479
2019-04-29 17:00:00,59,11,23,23,11,35,200,11,373
2019-04-29 18:00:00,94,23,47,0,11,70,82,0,327
2019-04-29 19:00:00,70,23,23,0,11,23,11,11,172
2019-04-29 20:00:00,47,11,11,0,11,23,59,11,173
2019-04-29 21:00:00,47,47,0,0,0,0,47,0,141
2019-04-29 22:00:00,35,11,0,0,11,23,11,0,91
2019-04-29 23:00:00,23,0,11,0,0,11,47,0,92
2019-04-30 00:00:00,35,0,0,0,0,11,11,11,68
2019-04-30 01:00:00,0,0,0,0,0,0,11,0,11
2019-04-30 02:00:00,0,0,0,0,0,0,11,0,11
2019-04-30 03:00:00,0,0,0,0,0,0,0,0,0
2019-04-30 04:00:00,0,0,0,0,0,0,0,0,0
2019-04-30 05:00:00,0,0,0,0,0,0,23,23,46
2019-04-30 06:00:00,47,0,0,0,0,0,35,0,82
2019-04-30 07:00:00,59,70,11,0,0,0,118,35,293
2019-04-30 08:00:00,129,59,23,0,0,11,106,188,516
2019-04-30 09:00:00,94,35,0,11,11,11,141,0,303
2019-04-30 10:00:00,94,23,11,0,11,11,212,23,385
2019-04-30 11:00:00,165,35,11,0,23,47,141,47,469
2019-04-30 12:00:00,224,59,23,23,35,165,413,59,1001
2019-04-30 13:00:00,200,82,35,23,11,47,141,141,680
2019-04-30 14:00:00,153,82,35,11,35,70,165,59,610
2019-04-30 15:00:00,259,94,59,0,11,82,106,23,634
2019-04-30 16:00:00,141,47,23,0,11,35,82,23,362
2019-04-30 17:00:00,70,35,11,11,0,47,82,94,350
2019-04-30 18:00:00,82,70,0,0,11,11,129,35,338
2019-04-30 19:00:00,82,11,11,0,11,47,11,0,173
2019-04-30 20:00:00,70,47,0,11,0,11,59,0,198
2019-04-30 21:00:00,11,11,0,0,35,47,11,0,115
2019-04-30 22:00:00,82,35,11,0,11,23,35,11,208
2019-04-30 23:00:00,11,11,0,0,11,23,0,11,67
2019-05-01 00:00:00,23,0,0,11,0,0,35,0,69
2019-05-01 01:00:00,0,0,0,0,0,0,0,0,0
2019-05-01 02:00:00,0,11,0,0,0,0,11,0,22
2019-05-01 03:00:00,0,0,0,0,0,0,0,11,11
2019-05-01 04:00:00,0,0,0,0,0,0,0,0,0
2019-05-01 05:00:00,0,11,0,0,0,0,0,0,11
2019-05-01 06:00:00,0,0,0,0,0,11,0,0,11
2019-05-01 07:00:00,0,0,0,0,0,0,0,0,0
2019-05-01 08:00:00,23,0,0,0,0,0,47,11,81
2019-05-01 09:00:00,47,0,0,11,11,23,23,0,115
2019-05-01 10:00:00,35,106,23,0,11,35,59,35,304
2019-05-01 11:00:00,106,141,35,35,23,23,165,23,551
2019-05-01 12:00:00,177,200,59,35,177,129,436,118,1331
2019-05-01 13:00:00,472,212,23,35,47,271,637,82,1779
2019-05-01 14:00:00,354,271,11,23,59,236,460,59,1473
2019-05-01 15:00:00,188,306,82,35,106,118,389,23,1247
2019-05-01 16:00:00,200,94,23,0,23,141,200,23,704
2019-05-01 17:00:00,118,177,47,23,35,70,295,35,800
2019-05-01 18:00:00,59,82,106,0,11,23,106,47,434
2019-05-01 19:00:00,82,23,11,11,23,35,70,11,266
2019-05-01 20:00:00,59,23,0,0,11,11,35,23,162
2019-05-01 21:00:00,0,11,0,11,11,11,35,0,79
2019-05-01 22:00:00,11,11,0,11,0,11,23,11,78
2019-05-01 23:00:00,0,0,0,0,0,0,11,0,11
2019-05-02 00:00:00,0,11,0,0,0,0,11,0,22
2019-05-02 01:00:00,0,0,0,0,0,0,11,0,11
2019-05-02 02:00:00,0,0,0,0,0,0,23,0,23
2019-05-02 03:00:00,0,0,0,0,0,0,23,0,23
2019-05-02 04:00:00,0,0,0,0,0,0,11,11,22
2019-05-02 05:00:00,35,0,0,0,0,0,11,0,46
2019-05-02 06:00:00,82,11,0,0,0,0,47,0,140
2019-05-02 07:00:00,118,70,11,0,0,0,47,35,281
2019-05-02 08:00:00,106,35,35,0,11,11,47,94,339
2019-05-02 09:00:00,59,59,47,11,23,0,11,0,210
2019-05-02 10:00:00,106,106,23,11,35,23,23,11,338
2019-05-02 11:00:00,47,141,47,11,11,35,11,0,303
2019-05-02 12:00:00,106,106,106,35,11,11,35,59,469
2019-05-02 13:00:00,177,129,35,11,35,70,59,59,575
2019-05-02 14:00:00,236,47,23,35,11,35,35,70,492
2019-05-02 15:00:00,236,47,47,11,0,70,23,23,457
2019-05-02 16:00:00,94,23,0,0,11,11,35,47,221
2019-05-02 17:00:00,59,35,23,23,11,59,0,11,221
2019-05-02 18:00:00,47,70,23,0,0,23,11,0,174
2019-05-02 19:00:00,82,11,0,0,47,47,23,11,221
2019-05-02 20:00:00,35,35,0,11,11,70,23,0,185
2019-05-02 21:00:00,23,0,0,0,11,23,11,23,91
2019-05-02 22:00:00,11,0,0,0,11,11,0,0,33
2019-05-02 23:00:00,35,0,11,0,0,11,0,0,57
2019-05-03 00:00:00,0,0,11,0,0,0,0,11,22
2019-05-03 01:00:00,0,11,0,0,0,0,0,0,11
2019-05-03 02:00:00,0,0,0,0,0,0,0,0,0
2019-05-03 03:00:00,0,11,0,0,0,0,0,0,11
2019-05-03 04:00:00,11,0,0,0,0,0,0,0,11
2019-05-03 05:00:00,0,11,0,0,0,0,0,0,11
2019-05-03 06:00:00,59,0,0,0,0,0,0,0,59
2019-05-03 07:00:00,70,0,0,0,0,11,82,35,198
2019-05-03 08:00:00,35,23,23,0,0,0,35,129,245
2019-05-03 09:00:00,59,23,11,11,11,11,94,0,220
2019-05-03 10:00:00,94,94,59,0,47,59,118,11,482
2019-05-03 11:00:00,200,59,35,0,0,70,94,70,528
2019-05-03 12:00:00,153,224,11,0,23,59,165,35,670
2019-05-03 13:00:00,106,23,129,23,23,47,212,35,598
2019-05-03 14:00:00,165,118,23,11,23,59,247,118,764
2019-05-03 15:00:00,153,59,23,11,23,59,236,70,634
2019-05-03 16:00:00,188,59,23,11,35,47,165,23,551
2019-05-03 17:00:00,70,23,23,11,23,47,129,23,349
2019-05-03 18:00:00,295,35,0,23,0,47,47,0,447
2019-05-03 19:00:00,118,23,0,0,11,23,47,23,245
2019-05-03 20:00:00,35,59,0,11,11,11,23,0,150
2019-05-03 21:00:00,47,106,11,11,11,35,70,0,291
2019-05-03 22:00:00,129,35,0,11,0,23,35,11,244
2019-05-03 23:00:00,59,23,0,0,0,0,70,0,152
2019-05-04 00:00:00,47,11,0,0,0,0,11,0,69
2019-05-04 01:00:00,0,0,0,0,0,0,11,11,22
2019-05-04 02:00:00,0,0,0,0,0,0,23,0,23
2019-05-04 03:00:00,0,0,0,0,0,0,0,0,0
2019-05-04 04:00:00,0,0,0,0,0,0,0,11,11
2019-05-04 05:00:00,0,0,0,0,0,0,0,0,0
2019-05-04 06:00:00,0,0,0,0,0,0,0,0,0
2019-05-04 07:00:00,11,11,0,0,0,0,11,23,56
2019-05-04 08:00:00,11,23,35,35,11,11,47,0,173
2019-05-04 09:00:00,59,59,23,70,23,23,106,0,363
2019-05-04 10:00:00,59,82,0,94,35,35,200,23,528
2019-05-04 11:00:00,141,153,11,224,0,70,389,23,1011
2019-05-04 12:00:00,212,259,23,153,70,165,790,0,1672
2019-05-04 13:00:00,212,318,35,141,70,188,979,11,1954
2019-05-04 14:00:00,153,224,47,118,70,165,979,70,1826
2019-05-04 15:00:00,318,283,23,59,47,59,1581,82,2452
2019-05-04 16:00:00,224,165,23,11,70,129,790,0,1412
2019-05-04 17:00:00,271,141,11,23,11,47,141,35,680
2019-05-04 18:00:00,153,70,23,11,0,0,82,0,339
2019-05-04 19:00:00,23,11,0,0,11,23,106,0,174
2019-05-04 20:00:00,35,35,35,0,0,0,47,11,163
2019-05-04 21:00:00,59,35,23,11,0,11,47,0,186
2019-05-04 22:00:00,70,47,11,0,0,11,35,0,174
2019-05-04 23:00:00,23,11,0,0,0,0,0,0,34
2019-05-05 00:00:00,11,0,0,0,0,0,0,11,22
2019-05-05 01:00:00,0,0,0,0,0,0,23,0,23
2019-05-05 02:00:00,0,23,0,0,0,0,11,0,34
2019-05-05 03:00:00,0,0,0,0,0,0,11,0,11
2019-05-05 04:00:00,0,0,0,0,0,0,35,0,35
2019-05-05 05:00:00,0,0,0,0,0,0,23,0,23
2019-05-05 06:00:00,11,0,0,0,0,0,70,0,81
2019-05-05 07:00:00,11,0,0,0,0,0,47,0,58
2019-05-05 08:00:00,0,0,11,11,11,0,23,0,56
2019-05-05 09:00:00,11,23,11,0,0,0,47,0,92
2019-05-05 10:00:00,94,59,47,23,11,11,82,23,350
2019-05-05 11:00:00,129,153,23,11,11,94,330,35,786
2019-05-05 12:00:00,212,318,11,35,82,200,601,23,1482
2019-05-05 13:00:00,129,247,118,59,224,318,814,35,1944
2019-05-05 14:00:00,236,141,59,23,94,224,519,11,1307
2019-05-05 15:00:00,259,188,35,23,70,141,448,23,1187
2019-05-05 16:00:00,94,82,0,23,35,47,330,11,622
2019-05-05 17:00:00,141,153,0,23,11,35,118,35,516
2019-05-05 18:00:00,35,106,35,11,35,47,165,11,445
2019-05-05 19:00:00,47,70,0,23,35,70,47,23,315
2019-05-05 20:00:00,11,35,23,0,0,23,0,0,92
2019-05-05 21:00:00,23,35,0,0,23,11,59,0,151
2019-05-05 22:00:00,11,11,0,11,0,11,11,0,55
2019-05-05 23:00:00,23,11,0,0,11,0,35,0,80
2019-05-06 00:00:00,11,0,0,0,0,0,0,0,11
2019-05-06 01:00:00,0,0,0,0,0,0,11,0,11
2019-05-06 02:00:00,0,0,0,0,0,0,0,0,0
2019-05-06 03:00:00,0,0,0,0,0,0,0,0,0
2019-05-06 04:00:00,0,0,0,0,0,0,0,0,0
2019-05-06 05:00:00,0,0,0,0,0,0,11,0,11
2019-05-06 06:00:00,94,11,0,0,0,0,35,0,140
2019-05-06 07:00:00,141,35,11,11,0,0,35,0,233
2019-05-06 08:00:00,153,47,59,0,0,0,47,0,306
2019-05-06 09:00:00,59,59,82,0,0,0,23,0,223
2019-05-06 10:00:00,59,94,23,0,0,0,94,0,270
2019-05-06 11:00:00,342,70,23,0,0,0,165,0,600
2019-05-06 12:00:00,118,82,11,0,0,0,200,0,411
2019-05-06 13:00:00,106,94,23,0,0,0,129,0,352
2019-05-06 14:00:00,247,47,11,11,0,0,118,0,434
2019-05-06 15:00:00,200,23,23,11,0,0,177,0,434
2019-05-06 16:00:00,94,35,11,0,0,0,70,0,210
2019-05-06 17:00:00,106,23,11,11,0,0,59,0,210
2019-05-06 18:00:00,129,59,0,11,0,0,59,0,258
2019-05-06 19:00:00,47,0,11,0,0,0,94,0,152
2019-05-06 20:00:00,23,11,0,0,0,0,59,0,93
2019-05-06 21:00:00,0,11,11,0,0,0,23,0,45
2019-05-06 22:00:00,11,11,0,0,0,0,59,0,81
2019-05-06 23:00:00,11,0,0,0,0,0,0,0,11
2019-05-07 00:00:00,0,0,0,0,0,0,11,0,11
2019-05-07 01:00:00,0,0,0,0,0,0,0,11,11
2019-05-07 02:00:00,0,11,0,0,0,0,23,0,34
2019-05-07 03:00:00,0,0,0,0,0,0,0,0,0
2019-05-07 04:00:00,0,0,0,0,0,0,11,0,11
2019-05-07 05:00:00,23,0,0,0,0,0,11,11,45
2019-05-07 06:00:00,59,23,0,0,0,0,35,0,117
2019-05-07 07:00:00,129,11,23,11,11,11,47,59,302
2019-05-07 08:00:00,188,70,47,23,11,0,94,106,539
2019-05-07 09:00:00,82,70,47,11,35,23,11,23,302
2019-05-07 10:00:00,82,94,23,11,141,118,153,11,633
2019-05-07 11:00:00,82,106,11,11,23,23,306,23,585
2019-05-07 12:00:00,165,35,35,11,47,35,342,23,693
2019-05-07 13:00:00,141,59,23,23,47,106,188,0,587
2019-05-07 14:00:00,106,82,47,0,59,59,118,35,506
2019-05-07 15:00:00,247,106,23,11,23,47,141,70,668
2019-05-07 16:00:00,141,35,59,0,0,35,94,11,375
2019-05-07 17:00:00,94,318,11,35,59,106,59,0,682
2019-05-07 18:00:00,259,70,11,23,59,11,82,23,538
2019-05-07 19:00:00,59,47,59,0,23,35,59,11,293
2019-05-07 20:00:00,82,59,0,0,11,47,35,23,257
2019-05-07 21:00:00,47,11,0,11,11,35,59,0,174
2019-05-07 22:00:00,11,0,0,0,0,11,11,11,44
2019-05-07 23:00:00,11,0,0,0,0,0,0,0,11
2019-05-08 00:00:00,0,0,0,0,0,0,0,0,0
2019-05-08 01:00:00,0,11,0,0,0,0,0,0,11
2019-05-08 02:00:00,11,0,0,0,0,0,23,0,34
2019-05-08 03:00:00,0,0,0,0,0,0,0,0,0
2019-05-08 04:00:00,0,0,0,0,0,0,0,0,0
2019-05-08 05:00:00,11,0,0,0,0,0,23,0,34
2019-05-08 06:00:00,35,11,0,0,0,0,35,0,81
2019-05-08 07:00:00,94,0,0,0,11,11,70,35,221
2019-05-08 08:00:00,94,94,0,47,23,11,106,118,493
2019-05-08 09:00:00,82,129,11,23,35,141,129,11,561
2019-05-08 10:00:00,295,118,23,0,11,70,129,23,669
2019-05-08 11:00:00,129,153,11,47,59,106,141,47,693
2019-05-08 12:00:00,200,35,47,59,47,106,306,35,835
2019-05-08 13:00:00,188,141,47,23,23,94,188,35,739
2019-05-08 14:00:00,295,153,11,0,59,23,212,59,812
2019-05-08 15:00:00,306,177,11,11,0,35,224,118,882
2019-05-08 16:00:00,94,35,11,0,70,59,106,35,410
2019-05-08 17:00:00,59,35,23,0,11,35,94,35,292
2019-05-08 18:00:00,47,11,47,0,23,35,59,0,222
2019-05-08 19:00:00,23,47,23,0,23,23,47,11,197
2019-05-08 20:00:00,59,70,11,11,23,23,23,0,220
2019-05-08 21:00:00,47,11,11,11,35,11,47,0,173
2019-05-08 22:00:00,23,0,0,0,0,0,23,47,93
2019-05-08 23:00:00,11,0,0,0,11,11,11,82,126
2019-05-09 00:00:00,0,0,0,0,0,0,11,11,22
2019-05-09 01:00:00,0,0,0,0,0,0,23,0,23
2019-05-09 02:00:00,0,0,0,0,0,0,23,0,23
2019-05-09 03:00:00,0,23,0,0,0,0,11,0,34
2019-05-09 04:00:00,0,11,0,0,0,0,11,0,22
2019-05-09 05:00:00,35,11,0,0,0,0,35,11,92
2019-05-09 06:00:00,59,59,0,0,0,0,70,23,211
2019-05-09 07:00:00,70,11,0,0,0,23,35,23,162
2019-05-09 08:00:00,82,47,0,0,11,23,106,70,339
2019-05-09 09:00:00,70,47,0,0,0,0,59,35,211
2019-05-09 10:00:00,11,47,0,0,11,23,35,11,138
2019-05-09 11:00:00,23,70,0,0,47,23,70,23,256
2019-05-09 12:00:00,141,35,0,11,11,23,59,23,303
2019-05-09 13:00:00,106,47,23,0,35,70,70,11,362
2019-05-09 14:00:00,141,11,11,0,23,11,82,35,314
2019-05-09 15:00:00,82,23,23,0,0,35,106,47,316
2019-05-09 16:00:00,70,11,11,0,0,23,59,11,185
2019-05-09 17:00:00,11,0,0,0,11,0,82,0,104
2019-05-09 18:00:00,47,11,0,11,23,47,59,11,209
2019-05-09 19:00:00,0,35,11,0,11,47,11,11,126
2019-05-09 20:00:00,0,11,0,0,0,23,59,0,93
2019-05-09 21:00:00,47,11,0,0,0,35,35,35,163
2019-05-09 22:00:00,35,0,0,0,0,23,0,0,58
2019-05-09 23:00:00,11,0,0,11,0,0,11,0,33
2019-05-10 00:00:00,0,0,0,0,0,0,0,0,0
2019-05-10 01:00:00,0,0,23,0,0,0,11,0,34
2019-05-10 02:00:00,11,11,11,0,0,0,11,0,44
2019-05-10 03:00:00,0,11,35,0,0,0,0,0,46
2019-05-10 04:00:00,0,11,11,0,0,0,0,0,22
2019-05-10 05:00:00,0,23,11,0,0,0,11,11,56
2019-05-10 06:00:00,47,23,11,0,0,0,0,11,92
2019-05-10 07:00:00,23,59,23,35,0,0,11,35,186
2019-05-10 08:00:00,70,59,11,0,0,23,35,165,363
2019-05-10 09:00:00,59,47,59,0,11,35,35,11,257
2019-05-10 10:00:00,59,47,59,23,11,35,47,23,304
2019-05-10 11:00:00,59,118,0,23,0,0,0,0,200
2019-05-10 12:00:00,47,47,0,11,0,0,0,0,105
2019-05-10 13:00:00,106,82,0,11,0,0,0,0,199
2019-05-10 14:00:00,106,82,0,0,0,0,0,0,188
2019-05-10 15:00:00,94,23,0,11,0,0,0,0,128
2019-05-10 16:00:00,47,59,0,23,0,0,0,0,129
2019-05-10 17:00:00,70,35,0,0,0,0,0,0,105
2019-05-10 18:00:00,59,23,0,11,0,0,0,0,93
2019-05-10 19:00:00,23,35,0,23,0,0,0,0,81
2019-05-10 20:00:00,0,70,0,0,0,0,0,0,70
2019-05-10 21:00:00,0,11,0,23,0,0,0,0,34
2019-05-10 22:00:00,23,23,0,0,0,0,0,0,46
2019-05-10 23:00:00,23,11,0,0,0,0,0,0,34
2019-05-11 00:00:00,11,11,0,0,0,0,0,0,22
2019-05-11 01:00:00,0,23,0,0,11,11,11,0,56
2019-05-11 02:00:00,11,0,23,0,0,0,11,23,68
2019-05-11 03:00:00,11,0,11,0,0,11,0,0,33
2019-05-11 04:00:00,0,11,0,0,0,0,0,0,11
2019-05-11 05:00:00,0,23,23,0,0,0,0,0,46
2019-05-11 06:00:00,0,11,11,0,0,0,0,0,22
2019-05-11 07:00:00,11,11,11,11,0,0,47,0,91
2019-05-11 08:00:00,0,47,35,70,0,11,47,0,210
2019-05-11 09:00:00,47,59,23,82,23,23,70,0,327
2019-05-11 10:00:00,70,59,11,129,23,23,129,0,444
2019-05-11 11:00:00,82,188,0,141,70,106,283,47,917
2019-05-11 12:00:00,295,377,47,200,35,200,637,70,1861
2019-05-11 13:00:00,177,295,23,259,141,318,826,59,2098
2019-05-11 14:00:00,165,542,47,247,106,118,672,82,1979
2019-05-11 15:00:00,436,849,23,82,82,153,826,106,2557
2019-05-11 16:00:00,389,330,11,47,70,94,377,59,1377
2019-05-11 17:00:00,212,70,0,35,82,11,141,47,598
2019-05-11 18:00:00,118,118,11,0,0,70,118,11,446
2019-05-11 19:00:00,47,23,23,0,35,23,23,11,185
2019-05-11 20:00:00,70,0,23,35,0,59,11,23,221
2019-05-11 21:00:00,11,11,0,0,0,11,23,0,56
2019-05-11 22:00:00,59,23,0,0,0,0,47,0,129
2019-05-11 23:00:00,47,0,11,0,0,0,59,0,117
2019-05-12 00:00:00,129,11,47,0,0,0,70,23,280
2019-05-12 01:00:00,23,0,11,23,0,11,35,0,103
2019-05-12 02:00:00,11,0,11,0,0,0,47,0,69
2019-05-12 03:00:00,0,0,0,0,0,11,11,0,22
2019-05-12 04:00:00,0,0,0,0,0,0,0,0,0
2019-05-12 05:00:00,0,0,0,11,0,0,0,0,11
2019-05-12 06:00:00,0,0,0,0,0,0,11,0,11
2019-05-12 07:00:00,0,0,0,0,0,0,0,0,0
2019-05-12 08:00:00,0,0,0,0,0,0,11,0,11
2019-05-12 09:00:00,35,35,0,0,11,0,11,11,103
2019-05-12 10:00:00,188,94,23,23,47,35,59,23,492
2019-05-12 11:00:00,11,70,23,47,23,70,177,35,456
2019-05-12 12:00:00,129,401,0,59,212,247,566,59,1673
2019-05-12 13:00:00,118,236,47,59,94,259,613,59,1485
2019-05-12 14:00:00,306,188,35,70,118,153,483,35,1388
2019-05-12 15:00:00,165,236,0,70,165,224,389,35,1284
2019-05-12 16:00:00,70,106,23,11,59,106,200,11,586
2019-05-12 17:00:00,165,82,0,0,118,47,165,59,636
2019-05-12 18:00:00,129,70,11,11,35,47,70,47,420
2019-05-12 19:00:00,70,23,11,11,23,35,47,35,255
2019-05-12 20:00:00,0,23,0,0,11,35,23,11,103
2019-05-12 21:00:00,47,35,11,0,11,11,11,23,149
2019-05-12 22:00:00,35,23,0,0,0,0,11,11,80
2019-05-12 23:00:00,11,23,0,0,11,11,11,0,67
2019-05-13 00:00:00,0,0,0,0,0,0,0,11,11
2019-05-13 01:00:00,0,0,0,0,0,0,23,0,23
2019-05-13 02:00:00,0,0,0,0,0,0,0,0,0
2019-05-13 03:00:00,0,0,0,0,0,0,11,0,11
2019-05-13 04:00:00,0,0,0,0,0,0,0,0,0
2019-05-13 05:00:00,0,0,0,0,0,0,0,0,0
2019-05-13 06:00:00,11,0,0,0,0,11,11,11,44
2019-05-13 07:00:00,141,47,0,0,0,0,23,70,281
2019-05-13 08:00:00,129,70,0,0,0,11,23,141,374
2019-05-13 09:00:00,47,94,0,0,35,11,23,11,221
2019-05-13 10:00:00,82,47,11,0,23,70,70,23,326
2019-05-13 11:00:00,70,35,11,0,23,23,82,35,279
2019-05-13 12:00:00,11,23,23,23,0,70,212,11,373
2019-05-13 13:00:00,118,35,0,23,23,47,141,23,410
2019-05-13 14:00:00,413,82,23,0,23,47,118,118,824
2019-05-13 15:00:00,224,11,0,23,11,70,247,35,621
2019-05-13 16:00:00,224,47,23,23,35,70,129,47,598
2019-05-13 17:00:00,177,47,0,11,23,47,59,47,411
2019-05-13 18:00:00,59,1014,11,11,35,70,153,11,1364
2019-05-13 19:00:00,35,696,23,0,11,35,82,35,917
2019-05-13 20:00:00,35,23,11,0,11,23,82,23,208
2019-05-13 21:00:00,23,23,0,0,0,0,35,0,81
2019-05-13 22:00:00,23,11,0,0,0,0,23,0,57
2019-05-13 23:00:00,0,0,0,0,0,23,11,0,34
2019-05-14 00:00:00,0,11,0,0,0,11,47,0,69
2019-05-14 01:00:00,0,0,11,0,0,0,23,0,34
2019-05-14 02:00:00,0,0,23,0,0,0,23,0,46
2019-05-14 03:00:00,0,0,0,0,0,0,0,0,0
2019-05-14 04:00:00,0,0,11,0,0,0,0,0,11
2019-05-14 05:00:00,11,0,23,0,0,0,0,0,34
2019-05-14 06:00:00,59,0,35,0,0,0,35,11,140
2019-05-14 07:00:00,59,23,35,0,0,35,82,47,281
2019-05-14 08:00:00,177,47,35,0,0,23,70,118,470
2019-05-14 09:00:00,47,35,70,11,0,0,94,0,257
2019-05-14 10:00:00,59,70,70,11,35,11,47,47,350
2019-05-14 11:00:00,82,82,35,11,0,11,165,35,421
2019-05-14 12:00:00,236,129,23,11,11,106,212,47,775
2019-05-14 13:00:00,129,165,35,0,59,70,153,47,658
2019-05-14 14:00:00,118,129,11,0,23,47,200,11,539
2019-05-14 15:00:00,129,59,35,35,47,70,224,11,610
2019-05-14 16:00:00,129,70,0,0,23,59,70,59,410
2019-05-14 17:00:00,70,94,0,0,23,23,153,35,398
2019-05-14 18:00:00,436,82,11,11,11,70,118,82,821
2019-05-14 19:00:00,59,47,0,11,47,47,59,23,293
2019-05-14 20:00:00,59,11,11,0,0,11,11,0,103
2019-05-14 21:00:00,23,23,0,11,0,0,106,23,186
2019-05-14 22:00:00,47,0,11,0,0,11,35,0,104
2019-05-14 23:00:00,0,0,0,0,0,0,11,11,22
2019-05-15 00:00:00,11,0,11,0,0,11,0,11,44
2019-05-15 01:00:00,0,0,0,0,11,0,35,0,46
2019-05-15 02:00:00,23,0,0,0,0,0,11,0,34
2019-05-15 03:00:00,0,0,0,0,0,0,23,0,23
2019-05-15 04:00:00,0,0,0,0,0,0,0,0,0
2019-05-15 05:00:00,23,11,0,0,0,0,0,11,45
2019-05-15 06:00:00,47,11,0,0,0,0,35,0,93
2019-05-15 07:00:00,70,35,0,0,0,0,59,35,199
2019-05-15 08:00:00,129,47,35,23,0,11,47,47,339
2019-05-15 09:00:00,70,59,70,47,35,11,94,35,421
2019-05-15 10:00:00,177,188,35,35,23,23,200,11,692
2019-05-15 11:00:00,342,118,47,23,59,47,236,11,883
2019-05-15 12:00:00,318,94,11,0,23,11,271,23,751
2019-05-15 13:00:00,129,153,35,23,47,47,177,59,670
2019-05-15 14:00:00,318,82,23,35,11,35,283,59,846
2019-05-15 15:00:00,129,129,35,23,59,141,283,11,810
2019-05-15 16:00:00,106,47,35,23,23,11,106,47,398
2019-05-15 17:00:00,70,23,59,11,23,23,129,23,361
2019-05-15 18:00:00,129,82,23,0,23,70,94,35,456
2019-05-15 19:00:00,259,118,23,0,47,70,94,23,634
2019-05-15 20:00:00,82,59,11,11,23,23,47,0,256
2019-05-15 21:00:00,35,11,0,0,11,35,47,35,174
2019-05-15 22:00:00,11,11,11,0,11,0,0,23,67
2019-05-15 23:00:00,11,0,0,0,0,0,0,11,22
2019-05-16 00:00:00,0,11,0,0,0,11,0,0,22
2019-05-16 01:00:00,0,0,0,0,0,0,0,0,0
2019-05-16 02:00:00,11,0,0,0,0,0,0,0,11
2019-05-16 03:00:00,0,0,0,0,0,0,0,0,0
2019-05-16 04:00:00,0,0,0,0,0,0,0,0,0
2019-05-16 05:00:00,0,11,0,0,0,0,0,0,11
2019-05-16 06:00:00,47,11,0,0,0,0,11,0,69
2019-05-16 07:00:00,94,11,11,0,11,0,70,82,279
2019-05-16 08:00:00,118,47,0,0,0,23,23,82,293
2019-05-16 09:00:00,118,47,23,0,0,23,82,11,304
2019-05-16 10:00:00,106,47,23,0,11,70,106,47,410
2019-05-16 11:00:00,94,82,47,0,0,0,153,47,423
2019-05-16 12:00:00,153,118,118,11,11,94,318,47,870
2019-05-16 13:00:00,236,153,94,11,11,94,118,59,776
2019-05-16 14:00:00,165,106,70,11,11,82,188,11,644
2019-05-16 15:00:00,236,94,59,0,11,94,200,70,764
2019-05-16 16:00:00,153,82,47,0,11,35,94,59,481
2019-05-16 17:00:00,153,23,0,0,11,47,47,11,292
2019-05-16 18:00:00,814,70,35,0,23,23,82,11,1058
2019-05-16 19:00:00,424,70,0,11,11,11,82,70,679
2019-05-16 20:00:00,11,23,0,0,0,11,47,11,103
2019-05-16 21:00:00,47,11,35,0,0,0,35,23,151
2019-05-16 22:00:00,0,11,35,0,0,0,35,0,81
2019-05-16 23:00:00,23,23,0,0,0,0,47,11,104
2019-05-17 00:00:00,11,0,0,0,0,11,35,0,57
2019-05-17 01:00:00,23,0,0,0,0,0,0,0,23
2019-05-17 02:00:00,23,0,0,0,0,0,0,11,34
2019-05-17 03:00:00,0,0,0,0,0,0,0,0,0
2019-05-17 04:00:00,0,0,0,0,0,0,0,0,0
2019-05-17 05:00:00,0,0,0,11,0,0,0,0,11
2019-05-17 06:00:00,11,11,0,0,0,11,11,0,44
2019-05-17 07:00:00,23,23,0,0,0,35,11,0,92
2019-05-17 08:00:00,23,188,11,0,35,70,47,0,374
2019-05-17 09:00:00,106,708,0,306,59,0,295,11,1485
2019-05-17 10:00:00,200,259,0,35,11,47,247,94,893
2019-05-17 11:00:00,814,271,0,11,47,141,295,212,1791
2019-05-17 12:00:00,696,106,23,11,35,35,236,118,1260
2019-05-17 13:00:00,318,188,0,11,23,82,188,70,880
2019-05-17 14:00:00,165,188,0,23,11,106,271,82,846
2019-05-17 15:00:00,118,200,23,0,59,59,224,106,789
2019-05-17 16:00:00,177,94,11,23,35,59,247,70,716
2019-05-17 17:00:00,153,82,0,11,11,129,153,23,562
2019-05-17 18:00:00,82,153,0,23,11,118,129,0,516
2019-05-17 19:00:00,11,82,0,0,23,59,47,0,222
2019-05-17 20:00:00,59,35,11,11,0,47,129,0,292
2019-05-17 21:00:00,35,23,0,0,35,23,59,236,411
2019-05-17 22:00:00,23,11,0,11,0,35,23,11,114
2019-05-17 23:00:00,35,0,0,0,0,23,47,0,105
2019-05-18 00:00:00,35,0,0,0,0,59,35,0,129
2019-05-18 01:00:00,0,0,0,0,0,0,0,11,11
2019-05-18 02:00:00,35,11,0,0,0,0,0,0,46
2019-05-18 03:00:00,0,0,0,0,0,0,35,0,35
2019-05-18 04:00:00,0,0,0,0,0,0,0,11,11
2019-05-18 05:00:00,0,0,0,0,0,0,0,0,0
2019-05-18 06:00:00,11,0,0,0,0,0,11,0,22
2019-05-18 07:00:00,0,0,0,0,0,0,0,0,0
2019-05-18 08:00:00,11,47,0,11,0,11,35,0,115
2019-05-18 09:00:00,23,23,11,35,11,0,59,11,173
2019-05-18 10:00:00,35,35,11,23,35,11,141,11,302
2019-05-18 11:00:00,118,141,0,141,11,35,283,35,764
2019-05-18 12:00:00,106,153,11,47,23,118,672,35,1165
2019-05-18 13:00:00,188,224,47,118,11,165,802,11,1566
2019-05-18 14:00:00,224,389,106,70,35,118,625,47,1614
2019-05-18 15:00:00,236,177,35,11,59,212,436,11,1177
2019-05-18 16:00:00,177,224,47,11,59,106,247,0,871
2019-05-18 17:00:00,118,59,59,11,70,35,118,23,493
2019-05-18 18:00:00,118,70,35,0,23,23,23,35,327
2019-05-18 19:00:00,23,23,11,0,23,11,23,11,125
2019-05-18 20:00:00,47,23,0,11,35,23,11,0,150
2019-05-18 21:00:00,70,0,0,0,23,0,47,23,163
2019-05-18 22:00:00,35,0,11,0,11,11,11,11,90
2019-05-18 23:00:00,236,11,0,0,11,0,11,11,280
2019-05-19 00:00:00,35,0,0,0,0,0,35,0,70
2019-05-19 01:00:00,23,11,23,0,0,0,11,0,68
2019-05-19 02:00:00,0,0,0,0,11,0,0,0,11
2019-05-19 03:00:00,0,23,0,0,0,0,35,0,58
2019-05-19 04:00:00,0,0,0,0,0,0,23,0,23
2019-05-19 05:00:00,0,0,0,0,0,0,0,0,0
2019-05-19 06:00:00,0,0,0,0,0,0,0,0,0
2019-05-19 07:00:00,0,0,0,0,0,0,11,0,11
2019-05-19 08:00:00,0,0,0,0,0,0,11,0,11
2019-05-19 09:00:00,47,11,0,0,11,0,0,0,69
2019-05-19 10:00:00,35,35,23,11,11,35,47,0,197
2019-05-19 11:00:00,106,106,23,35,35,35,129,0,469
2019-05-19 12:00:00,118,106,35,11,59,70,247,11,657
2019-05-19 13:00:00,188,188,70,0,129,188,354,47,1164
2019-05-19 14:00:00,236,495,70,23,82,212,306,82,1506
2019-05-19 15:00:00,188,342,35,23,153,283,342,47,1413
2019-05-19 16:00:00,177,141,70,23,70,129,259,11,880
2019-05-19 17:00:00,200,106,70,11,59,247,70,59,822
2019-05-19 18:00:00,94,94,11,0,23,70,47,35,374
2019-05-19 19:00:00,59,23,11,0,11,35,59,23,221
2019-05-19 20:00:00,23,47,0,23,11,11,23,0,138
2019-05-19 21:00:00,0,47,0,0,0,11,0,0,58
2019-05-19 22:00:00,11,0,0,0,0,0,0,0,11
2019-05-19 23:00:00,11,0,0,0,0,0,11,0,22
2019-05-20 00:00:00,0,0,0,0,0,0,0,0,0
2019-05-20 01:00:00,0,0,0,0,0,0,0,0,0
2019-05-20 02:00:00,0,0,0,0,0,0,0,0,0
2019-05-20 03:00:00,0,0,0,0,0,0,0,0,0
2019-05-20 04:00:00,0,0,0,0,0,0,0,0,0
2019-05-20 05:00:00,0,11,0,0,0,0,0,0,11
2019-05-20 06:00:00,23,0,0,0,0,0,35,11,69
2019-05-20 07:00:00,35,23,11,0,11,0,23,23,126
2019-05-20 08:00:00,70,47,0,0,0,0,35,129,281
2019-05-20 09:00:00,23,0,11,0,11,23,0,0,68
2019-05-20 10:00:00,35,23,11,0,0,35,177,11,292
2019-05-20 11:00:00,11,23,23,0,23,23,141,23,267
2019-05-20 12:00:00,59,35,23,0,11,0,141,23,292
2019-05-20 13:00:00,94,35,94,11,59,11,129,23,456
2019-05-20 14:00:00,153,59,82,0,23,94,118,118,647
2019-05-20 15:00:00,153,59,35,23,47,35,200,11,563
2019-05-20 16:00:00,118,47,0,0,35,47,177,11,435
2019-05-20 17:00:00,59,59,35,11,23,47,129,0,363
2019-05-20 18:00:00,35,0,342,0,23,23,35,35,493
2019-05-20 19:00:00,35,23,23,0,0,35,70,23,209
2019-05-20 20:00:00,35,11,0,0,23,0,47,0,116
2019-05-20 21:00:00,35,23,0,11,11,0,47,11,138
2019-05-20 22:00:00,23,11,0,11,0,11,23,0,79
2019-05-20 23:00:00,11,0,0,0,0,0,0,0,11
2019-05-21 00:00:00,0,11,0,0,0,0,11,0,22
2019-05-21 01:00:00,0,0,11,0,0,0,0,0,11
2019-05-21 02:00:00,0,11,0,0,0,0,0,0,11
2019-05-21 03:00:00,0,0,0,0,0,0,0,0,0
2019-05-21 04:00:00,0,0,0,0,0,0,0,0,0
2019-05-21 05:00:00,11,35,0,0,0,0,0,0,46
2019-05-21 06:00:00,23,35,0,0,0,0,0,23,81
2019-05-21 07:00:00,47,35,0,0,0,0,0,35,117
2019-05-21 08:00:00,106,118,11,0,11,11,0,59,316
2019-05-21 09:00:00,59,247,0,35,0,47,0,11,399
2019-05-21 10:00:00,153,247,35,23,70,47,0,47,622
2019-05-21 11:00:00,236,94,47,23,47,118,0,47,612
2019-05-21 12:00:00,165,188,59,0,35,94,0,35,576
2019-05-21 13:00:00,188,141,23,0,11,94,0,59,516
2019-05-21 14:00:00,165,70,59,23,11,47,82,94,551
2019-05-21 15:00:00,141,165,11,23,23,82,200,118,763
2019-05-21 16:00:00,177,306,47,0,11,70,129,35,775
2019-05-21 17:00:00,165,106,47,11,0,59,153,23,564
2019-05-21 18:00:00,118,59,11,35,94,82,59,23,481
2019-05-21 19:00:00,118,47,11,0,11,11,35,23,256
2019-05-21 20:00:00,35,11,47,0,11,11,59,0,174
2019-05-21 21:00:00,47,23,11,0,47,35,35,82,280
2019-05-21 22:00:00,23,0,11,0,0,35,0,23,92
2019-05-21 23:00:00,23,11,0,0,11,0,11,0,56
2019-05-22 00:00:00,0,0,0,0,0,0,0,0,0
2019-05-22 01:00:00,0,0,0,0,0,0,11,0,11
2019-05-22 02:00:00,11,0,0,0,0,0,0,11,22
2019-05-22 03:00:00,0,0,0,0,0,0,0,0,0
2019-05-22 04:00:00,11,0,0,0,0,0,0,0,11
2019-05-22 05:00:00,0,0,0,0,0,0,0,0,0
2019-05-22 06:00:00,11,11,0,11,0,0,23,11,67
2019-05-22 07:00:00,47,35,0,0,0,0,35,11,128
2019-05-22 08:00:00,106,35,11,11,11,23,59,23,279
2019-05-22 09:00:00,70,59,35,0,0,11,59,23,257
2019-05-22 10:00:00,94,23,23,11,11,35,70,11,278
2019-05-22 11:00:00,118,106,35,11,47,94,118,35,564
2019-05-22 12:00:00,141,141,35,35,59,47,165,70,693
2019-05-22 13:00:00,224,94,94,11,23,23,129,82,680
2019-05-22 14:00:00,106,94,23,0,35,23,177,106,564
2019-05-22 15:00:00,212,59,11,11,11,47,188,47,586
2019-05-22 16:00:00,94,59,11,35,35,106,141,47,528
2019-05-22 17:00:00,82,35,0,0,47,59,153,11,387
2019-05-22 18:00:00,129,70,82,23,35,23,59,23,444
2019-05-22 19:00:00,271,59,11,0,47,70,47,11,516
2019-05-22 20:00:00,47,11,0,0,11,70,35,0,174
2019-05-22 21:00:00,94,23,11,0,35,11,47,11,232
2019-05-22 22:00:00,59,11,0,0,11,11,35,11,138
2019-05-22 23:00:00,0,0,11,0,0,0,11,11,33
2019-05-23 00:00:00,0,0,0,0,0,0,11,0,11
2019-05-23 01:00:00,0,11,0,0,0,0,0,0,11
2019-05-23 02:00:00,11,0,0,0,0,0,0,0,11
2019-05-23 03:00:00,0,0,0,0,0,0,0,0,0
2019-05-23 04:00:00,0,0,0,0,0,0,0,0,0
2019-05-23 05:00:00,11,0,0,0,0,0,0,0,11
2019-05-23 06:00:00,11,35,0,0,0,0,11,0,57
2019-05-23 07:00:00,59,47,0,0,0,11,11,0,128
2019-05-23 08:00:00,106,11,11,0,0,23,47,70,268
2019-05-23 09:00:00,70,59,11,35,35,11,23,35,279
2019-05-23 10:00:00,141,11,23,0,11,35,94,70,385
2019-05-23 11:00:00,129,59,59,23,11,59,165,141,646
2019-05-23 12:00:00,118,94,118,47,47,141,118,11,694
2019-05-23 13:00:00,82,94,23,0,59,82,118,94,552
2019-05-23 14:00:00,153,70,47,0,0,106,82,11,469
2019-05-23 15:00:00,106,118,35,47,23,59,129,59,576
2019-05-23 16:00:00,153,129,35,82,23,47,200,11,680
2019-05-23 17:00:00,59,23,23,23,11,11,47,47,244
2019-05-23 18:00:00,70,23,11,0,59,70,59,0,292
2019-05-23 19:00:00,70,59,59,0,35,11,47,35,316
2019-05-23 20:00:00,82,59,11,0,0,11,70,11,244
2019-05-23 21:00:00,47,59,0,11,47,59,47,0,270
2019-05-23 22:00:00,11,11,0,0,0,0,35,0,57
2019-05-23 23:00:00,23,0,0,0,0,0,11,0,34
2019-05-24 00:00:00,0,11,0,0,0,0,11,0,22
2019-05-24 01:00:00,11,0,0,0,0,0,11,0,22
2019-05-24 02:00:00,0,0,0,0,0,0,11,0,11
2019-05-24 03:00:00,0,0,0,0,0,0,23,0,23
2019-05-24 04:00:00,0,0,0,0,0,0,11,0,11
2019-05-24 05:00:00,0,0,11,0,0,0,23,0,34
2019-05-24 06:00:00,11,11,0,0,0,0,11,0,33
2019-05-24 07:00:00,47,11,0,0,0,0,23,23,104
2019-05-24 08:00:00,82,23,70,0,0,0,47,35,257
2019-05-24 09:00:00,35,59,59,0,0,0,35,23,211
2019-05-24 10:00:00,23,35,47,0,23,0,106,0,234
2019-05-24 11:00:00,118,35,11,0,0,0,200,11,375
2019-05-24 12:00:00,82,177,35,0,23,0,259,47,623
2019-05-24 13:00:00,247,212,47,0,35,0,212,59,812
2019-05-24 14:00:00,424,106,11,0,11,0,212,59,823
2019-05-24 15:00:00,177,47,0,0,11,0,271,35,541
2019-05-24 16:00:00,82,82,23,0,0,0,259,23,469
2019-05-24 17:00:00,94,35,35,0,0,0,129,0,293
2019-05-24 18:00:00,259,47,0,0,23,0,59,0,388
2019-05-24 19:00:00,70,23,0,0,0,0,59,23,175
2019-05-24 20:00:00,11,47,11,0,11,0,35,23,138
2019-05-24 21:00:00,70,59,0,0,0,0,47,0,176
2019-05-24 22:00:00,23,11,11,0,0,0,59,11,115
2019-05-24 23:00:00,35,35,0,0,35,23,47,0,175
2019-05-25 00:00:00,23,11,0,0,0,0,35,0,69
2019-05-25 01:00:00,47,0,0,0,0,23,11,0,81
2019-05-25 02:00:00,11,11,0,11,0,0,23,0,56
2019-05-25 03:00:00,0,11,0,11,0,0,0,0,22
2019-05-25 04:00:00,0,0,0,0,0,0,0,0,0
2019-05-25 05:00:00,11,0,0,0,0,0,0,0,11
2019-05-25 06:00:00,0,0,0,0,0,0,23,0,23
2019-05-25 07:00:00,11,0,0,0,0,0,35,0,46
2019-05-25 08:00:00,23,0,0,11,0,0,23,0,57
2019-05-25 09:00:00,59,82,23,106,0,23,129,0,422
2019-05-25 10:00:00,106,141,0,106,11,82,177,11,634
2019-05-25 11:00:00,200,472,82,212,59,129,259,47,1460
2019-05-25 12:00:00,377,436,70,236,106,212,460,47,1944
2019-05-25 13:00:00,318,354,0,318,82,247,660,35,2014
2019-05-25 14:00:00,271,436,35,259,82,306,542,11,1942
2019-05-25 15:00:00,271,177,47,188,82,200,377,23,1365
2019-05-25 16:00:00,212,188,35,59,23,94,330,35,976
2019-05-25 17:00:00,283,94,59,11,11,94,177,35,764
2019-05-25 18:00:00,82,153,47,11,47,59,141,23,563
2019-05-25 19:00:00,70,35,23,11,0,47,82,0,268
2019-05-25 20:00:00,94,0,0,11,0,11,70,11,197
2019-05-25 21:00:00,23,11,11,0,0,23,23,11,102
2019-05-25 22:00:00,23,0,0,0,0,0,35,11,69
2019-05-25 23:00:00,23,0,0,23,0,0,47,35,128
2019-05-26 00:00:00,59,11,0,0,0,11,11,0,92
2019-05-26 01:00:00,23,0,0,0,0,0,0,0,23
2019-05-26 02:00:00,11,0,0,0,0,0,35,11,57
2019-05-26 03:00:00,23,0,0,0,0,0,11,11,45
2019-05-26 04:00:00,0,0,0,0,0,0,0,0,0
2019-05-26 05:00:00,0,0,0,0,0,0,0,0,0
2019-05-26 06:00:00,0,11,0,0,0,0,0,0,11
2019-05-26 07:00:00,0,11,0,0,11,0,0,0,22
2019-05-26 08:00:00,0,0,0,0,0,0,35,0,35
2019-05-26 09:00:00,11,23,0,0,0,0,70,0,104
2019-05-26 10:00:00,23,94,11,11,11,35,47,23,255
2019-05-26 11:00:00,82,259,11,35,11,47,118,47,610
2019-05-26 12:00:00,129,153,11,35,47,94,495,70,1034
2019-05-26 13:00:00,188,389,11,47,11,129,554,35,1364
2019-05-26 14:00:00,200,424,59,70,153,212,684,23,1825
2019-05-26 15:00:00,141,271,59,82,82,200,542,59,1436
2019-05-26 16:00:00,153,354,47,0,35,118,413,35,1155
2019-05-26 17:00:00,236,153,0,47,35,129,271,59,930
2019-05-26 18:00:00,118,106,0,0,11,35,129,23,422
2019-05-26 19:00:00,47,70,0,0,0,59,35,23,234
2019-05-26 20:00:00,23,23,0,0,0,35,35,0,116
2019-05-26 21:00:00,11,0,0,0,0,0,11,11,33
2019-05-26 22:00:00,0,0,0,0,0,0,0,11,11
2019-05-26 23:00:00,11,0,0,0,0,0,11,0,22
2019-05-27 00:00:00,0,0,0,0,0,0,0,0,0
2019-05-27 01:00:00,0,0,0,0,0,0,0,0,0
2019-05-27 02:00:00,11,0,0,0,0,0,0,0,11
2019-05-27 03:00:00,0,0,0,0,0,0,0,0,0
2019-05-27 04:00:00,0,0,0,0,0,0,0,0,0
2019-05-27 05:00:00,23,0,0,0,0,0,23,11,57
2019-05-27 06:00:00,59,11,0,0,0,0,0,0,70
2019-05-27 07:00:00,106,23,0,0,0,0,0,35,164
2019-05-27 08:00:00,129,70,0,11,23,35,23,11,302
2019-05-27 09:00:00,82,82,0,0,11,11,47,11,244
2019-05-27 10:00:00,82,59,0,0,11,23,106,11,292
2019-05-27 11:00:00,177,106,0,11,0,11,129,23,457
2019-05-27 12:00:00,153,141,23,23,23,70,177,35,645
2019-05-27 13:00:00,259,82,47,0,59,70,177,82,776
2019-05-27 14:00:00,188,70,11,23,11,141,129,59,632
2019-05-27 15:00:00,212,82,0,0,35,47,129,35,540
2019-05-27 16:00:00,47,82,0,11,35,70,165,35,445
2019-05-27 17:00:00,70,47,11,11,11,35,47,0,232
2019-05-27 18:00:00,11,94,11,11,0,23,47,0,197
2019-05-27 19:00:00,129,23,11,11,11,11,59,0,255
2019-05-27 20:00:00,47,11,0,0,0,11,47,0,116
2019-05-27 21:00:00,35,35,0,11,11,35,59,11,197
2019-05-27 22:00:00,35,11,0,11,0,0,0,11,68
2019-05-27 23:00:00,47,11,0,0,0,11,11,0,80
2019-05-28 00:00:00,0,0,0,0,0,11,11,0,22
2019-05-28 01:00:00,11,0,0,0,0,11,0,0,22
2019-05-28 02:00:00,0,0,0,0,0,0,0,0,0
2019-05-28 03:00:00,0,0,0,0,0,0,11,0,11
2019-05-28 04:00:00,0,0,0,0,0,0,0,0,0
2019-05-28 05:00:00,11,0,0,0,0,0,23,0,34
2019-05-28 06:00:00,35,23,0,0,0,11,35,0,104
2019-05-28 07:00:00,94,11,0,0,11,11,11,35,173
2019-05-28 08:00:00,129,0,0,0,0,11,23,118,281
2019-05-28 09:00:00,70,59,82,0,11,11,94,11,338
2019-05-28 10:00:00,82,35,11,35,23,23,70,47,326
2019-05-28 11:00:00,70,94,35,23,23,11,188,35,479
2019-05-28 12:00:00,106,141,0,0,23,82,129,47,528
2019-05-28 13:00:00,118,94,23,47,23,129,153,35,622
2019-05-28 14:00:00,118,94,11,23,35,141,165,47,634
2019-05-28 15:00:00,200,129,11,11,11,59,236,23,680
2019-05-28 16:00:00,106,70,47,23,11,70,165,47,539
2019-05-28 17:00:00,94,70,23,0,47,70,82,11,397
2019-05-28 18:00:00,82,177,23,11,59,106,94,23,575
2019-05-28 19:00:00,23,47,23,23,0,165,94,0,375
2019-05-28 20:00:00,35,59,23,23,11,23,70,23,267
2019-05-28 21:00:00,35,35,0,11,47,47,35,0,210
2019-05-28 22:00:00,47,23,0,0,0,11,23,11,115
2019-05-28 23:00:00,23,11,0,0,0,23,11,0,68
2019-05-29 00:00:00,0,0,0,0,0,0,0,0,0
2019-05-29 01:00:00,0,0,0,0,0,0,11,0,11
2019-05-29 02:00:00,0,0,11,0,0,0,0,0,11
2019-05-29 03:00:00,0,0,0,0,0,0,11,0,11
2019-05-29 04:00:00,0,0,0,0,0,0,11,0,11
2019-05-29 05:00:00,23,11,0,0,0,0,11,0,45
2019-05-29 06:00:00,59,11,0,0,0,0,0,47,117
2019-05-29 07:00:00,70,0,0,0,11,11,0,23,115
2019-05-29 08:00:00,82,47,35,0,0,23,47,35,269
2019-05-29 09:00:00,47,82,23,0,47,11,35,11,256
2019-05-29 10:00:00,106,70,0,0,47,47,129,11,410
2019-05-29 11:00:00,118,129,23,11,0,47,460,23,811
2019-05-29 12:00:00,129,259,11,23,106,94,259,47,928
2019-05-29 13:00:00,271,118,0,35,23,129,271,47,894
2019-05-29 14:00:00,141,118,11,23,23,82,283,35,716
2019-05-29 15:00:00,177,129,11,0,23,23,70,35,468
2019-05-29 16:00:00,141,35,0,0,23,11,59,59,328
2019-05-29 17:00:00,106,35,11,23,23,11,59,0,268
2019-05-29 18:00:00,94,118,23,0,47,70,141,11,504
2019-05-29 19:00:00,118,82,11,0,11,11,118,11,362
2019-05-29 20:00:00,35,0,0,0,0,94,59,0,188
2019-05-29 21:00:00,35,11,0,11,11,23,35,0,126
2019-05-29 22:00:00,59,11,0,0,11,11,70,0,162
2019-05-29 23:00:00,11,0,11,0,0,59,47,0,128
2019-05-30 00:00:00,0,0,0,0,11,11,11,0,33
2019-05-30 01:00:00,23,0,0,0,0,11,11,11,56
2019-05-30 02:00:00,0,0,0,0,0,0,23,0,23
2019-05-30 03:00:00,0,0,0,0,0,0,11,0,11
2019-05-30 04:00:00,0,0,0,0,0,0,23,0,23
2019-05-30 05:00:00,0,0,0,0,0,0,23,0,23
2019-05-30 06:00:00,0,11,0,0,0,0,0,0,11
2019-05-30 07:00:00,11,0,0,0,0,0,23,0,34
2019-05-30 08:00:00,11,0,11,0,0,0,11,0,33
2019-05-30 09:00:00,0,47,0,0,0,0,47,11,105
2019-05-30 10:00:00,11,23,11,0,0,11,59,11,126
2019-05-30 11:00:00,35,11,11,0,0,70,94,0,221
2019-05-30 12:00:00,23,0,59,0,0,0,153,11,246
2019-05-30 13:00:00,23,0,11,0,0,11,259,0,304
2019-05-30 14:00:00,59,23,0,11,11,23,129,0,256
2019-05-30 15:00:00,59,47,11,11,0,11,342,11,492
2019-05-30 16:00:00,35,118,0,11,35,59,637,0,895
2019-05-30 17:00:00,35,59,23,11,23,35,165,0,351
2019-05-30 18:00:00,35,106,23,11,23,11,70,11,290
2019-05-30 19:00:00,47,165,11,0,35,35,47,0,340
2019-05-30 20:00:00,35,11,11,0,0,11,35,11,114
2019-05-30 21:00:00,0,11,0,0,0,23,35,0,69
2019-05-30 22:00:00,0,11,0,11,0,11,11,11,55
2019-05-30 23:00:00,0,0,0,0,0,0,0,23,23
2019-05-31 00:00:00,0,0,23,0,0,0,11,0,34
2019-05-31 01:00:00,0,0,0,0,0,0,11,0,11
2019-05-31 02:00:00,0,0,0,0,0,0,23,0,23
2019-05-31 03:00:00,0,0,0,0,0,0,35,0,35
2019-05-31 04:00:00,0,0,0,0,0,0,11,0,11
2019-05-31 05:00:00,11,0,0,0,0,0,11,0,22
2019-05-31 06:00:00,0,11,0,0,0,0,11,11,33
2019-05-31 07:00:00,35,0,0,0,0,11,59,0,105
2019-05-31 08:00:00,35,23,0,0,0,0,47,11,116
2019-05-31 09:00:00,47,82,0,0,0,11,23,11,174
2019-05-31 10:00:00,141,460,35,0,23,59,283,47,1048
2019-05-31 11:00:00,212,306,82,11,70,82,531,47,1341
2019-05-31 12:00:00,283,330,35,70,35,141,472,70,1436
2019-05-31 13:00:00,318,141,70,59,47,129,613,23,1400
2019-05-31 14:00:00,271,200,82,23,59,106,554,23,1318
2019-05-31 15:00:00,318,153,0,35,23,365,365,11,1270
2019-05-31 16:00:00,212,82,47,0,59,177,436,11,1024
2019-05-31 17:00:00,283,70,47,11,11,11,141,47,621
2019-05-31 18:00:00,129,47,11,11,23,47,306,11,585
2019-05-31 19:00:00,129,70,23,0,11,47,70,59,409
2019-05-31 20:00:00,94,11,11,11,23,23,35,11,219
2019-05-31 21:00:00,59,23,0,35,0,47,118,11,293
2019-05-31 22:00:00,59,23,11,0,0,59,59,11,222
2019-05-31 23:00:00,23,0,0,0,0,35,82,23,163
2019-06-01 00:00:00,11,0,0,11,11,0,35,0,68
2019-06-01 01:00:00,35,11,0,0,0,0,35,23,104
2019-06-01 02:00:00,23,11,0,0,0,11,23,0,68
2019-06-01 03:00:00,0,0,0,0,0,0,11,11,22
2019-06-01 04:00:00,11,11,0,0,0,0,0,0,22
2019-06-01 05:00:00,0,0,0,0,0,0,11,0,11
2019-06-01 06:00:00,0,0,0,0,0,0,0,0,0
2019-06-01 07:00:00,0,0,0,0,0,0,23,0,23
2019-06-01 08:00:00,35,0,0,0,0,0,23,0,58
2019-06-01 09:00:00,11,23,0,23,11,11,59,23,161
2019-06-01 10:00:00,23,59,23,11,23,0,153,0,292
2019-06-01 11:00:00,70,224,23,70,11,59,601,11,1069
2019-06-01 12:00:00,129,436,47,188,23,59,1038,11,1931
2019-06-01 13:00:00,200,247,35,141,59,165,991,0,1838
2019-06-01 14:00:00,129,483,35,141,59,141,908,23,1919
2019-06-01 15:00:00,247,188,35,153,47,188,531,47,1436
2019-06-01 16:00:00,330,212,94,23,47,141,637,0,1484
2019-06-01 17:00:00,342,141,23,59,47,70,283,59,1024
2019-06-01 18:00:00,601,106,0,11,11,106,129,23,987
2019-06-01 19:00:00,153,70,0,11,0,35,35,11,315
2019-06-01 20:00:00,94,94,0,11,0,23,82,11,315
2019-06-01 21:00:00,35,94,0,11,0,11,23,11,185
2019-06-01 22:00:00,35,23,0,11,35,0,70,0,174
2019-06-01 23:00:00,23,0,0,23,11,11,23,0,91
2019-06-02 00:00:00,35,0,0,0,11,0,0,11,57
2019-06-02 01:00:00,47,0,0,0,11,11,0,0,69
2019-06-02 02:00:00,23,0,0,0,11,0,35,0,69
2019-06-02 03:00:00,0,11,0,0,11,0,0,0,22
2019-06-02 04:00:00,0,0,0,0,0,0,0,0,0
2019-06-02 05:00:00,0,0,0,0,0,0,11,0,11
2019-06-02 06:00:00,0,0,0,0,0,0,11,0,11
2019-06-02 07:00:00,0,0,23,0,0,0,23,0,46
2019-06-02 08:00:00,0,0,0,0,0,0,47,11,58
2019-06-02 09:00:00,47,59,11,11,0,23,59,0,210
2019-06-02 10:00:00,59,106,11,0,11,35,118,11,351
2019-06-02 11:00:00,165,165,94,0,35,318,153,23,953
2019-06-02 12:00:00,247,377,118,23,23,365,1050,70,2273
2019-06-02 13:00:00,236,554,188,23,47,236,1073,47,2404
2019-06-02 14:00:00,247,283,94,0,35,153,590,94,1496
2019-06-02 15:00:00,271,212,11,35,23,153,495,59,1259
2019-06-02 16:00:00,94,94,11,11,35,11,342,35,633
2019-06-02 17:00:00,719,59,35,0,0,23,23,11,870
2019-06-02 18:00:00,70,106,11,0,11,23,35,0,256
2019-06-02 19:00:00,23,47,11,0,0,11,59,0,151
2019-06-02 20:00:00,11,11,0,0,0,11,23,23,79
2019-06-02 21:00:00,23,11,0,0,11,11,11,0,67
2019-06-02 22:00:00,23,0,0,0,0,23,0,11,57
2019-06-02 23:00:00,11,23,0,0,23,23,0,0,80
2019-06-03 00:00:00,0,0,0,0,0,11,0,0,11
2019-06-03 01:00:00,0,0,0,0,0,0,0,0,0
2019-06-03 02:00:00,0,0,0,0,0,0,11,0,11
2019-06-03 03:00:00,0,0,0,0,0,0,0,0,0
2019-06-03 04:00:00,0,0,0,0,0,0,0,0,0
2019-06-03 05:00:00,35,11,0,0,0,0,0,0,46
2019-06-03 06:00:00,47,11,0,0,0,0,11,11,80
2019-06-03 07:00:00,82,35,0,0,11,23,23,35,209
2019-06-03 08:00:00,70,11,11,0,35,11,0,129,267
2019-06-03 09:00:00,59,59,0,0,70,0,59,35,282
2019-06-03 10:00:00,35,106,23,11,11,0,47,59,292
2019-06-03 11:00:00,153,82,11,11,11,35,129,11,443
2019-06-03 12:00:00,94,47,23,35,47,35,177,35,493
2019-06-03 13:00:00,94,118,0,23,11,35,129,35,445
2019-06-03 14:00:00,129,47,11,11,47,94,259,70,668
2019-06-03 15:00:00,188,23,59,11,11,82,129,82,585
2019-06-03 16:00:00,106,153,23,23,35,141,177,35,693
2019-06-03 17:00:00,188,47,11,0,11,106,82,35,480
2019-06-03 18:00:00,70,82,35,0,47,94,94,11,433
2019-06-03 19:00:00,82,106,47,23,47,47,82,35,469
2019-06-03 20:00:00,35,70,11,11,11,82,11,47,278
2019-06-03 21:00:00,70,11,0,0,0,0,23,47,151
2019-06-03 22:00:00,11,11,0,0,0,0,11,0,33
2019-06-03 23:00:00,11,23,0,11,11,23,11,0,90
2019-06-04 00:00:00,11,0,0,0,0,11,0,0,22
2019-06-04 01:00:00,0,0,0,0,0,0,0,0,0
2019-06-04 02:00:00,0,11,0,0,0,0,0,0,11
2019-06-04 03:00:00,0,0,0,0,0,0,0,0,0
2019-06-04 04:00:00,0,0,0,0,0,0,23,0,23
2019-06-04 05:00:00,23,0,0,11,0,0,11,0,45
2019-06-04 06:00:00,47,11,0,0,0,11,70,11,150
2019-06-04 07:00:00,118,82,0,11,0,11,11,47,280
2019-06-04 08:00:00,106,59,11,0,11,11,59,47,304
2019-06-04 09:00:00,188,141,11,11,35,35,106,59,586
2019-06-04 10:00:00,106,224,11,11,23,70,129,11,585
2019-06-04 11:00:00,271,212,0,35,23,82,212,70,905
2019-06-04 12:00:00,118,165,23,23,11,70,165,11,586
2019-06-04 13:00:00,141,236,23,0,11,47,141,59,658
2019-06-04 14:00:00,106,153,35,23,23,11,295,35,681
2019-06-04 15:00:00,200,236,23,11,59,59,141,59,788
2019-06-04 16:00:00,118,188,59,59,47,129,318,70,988
2019-06-04 17:00:00,129,295,70,0,82,47,82,11,716
2019-06-04 18:00:00,165,59,59,11,82,94,47,23,540
2019-06-04 19:00:00,59,82,0,23,59,82,129,11,445
2019-06-04 20:00:00,153,35,0,47,0,35,94,35,399
2019-06-04 21:00:00,0,47,59,0,59,35,59,0,259
2019-06-04 22:00:00,472,0,11,0,0,23,23,0,529
2019-06-04 23:00:00,11,0,0,0,11,0,0,11,33
2019-06-05 00:00:00,11,0,0,0,0,0,0,0,11
2019-06-05 01:00:00,11,11,0,0,0,0,0,0,22
2019-06-05 02:00:00,11,0,0,0,0,0,0,0,11
2019-06-05 03:00:00,0,0,0,0,0,0,0,0,0
2019-06-05 04:00:00,0,0,0,0,0,0,11,0,11
2019-06-05 05:00:00,35,11,0,0,0,0,23,11,80
2019-06-05 06:00:00,70,23,0,11,0,47,11,0,162
2019-06-05 07:00:00,70,23,35,0,0,11,106,47,292
2019-06-05 08:00:00,106,35,35,0,11,11,59,35,292
2019-06-05 09:00:00,70,153,0,11,11,35,47,35,362
2019-06-05 10:00:00,106,224,11,23,59,35,118,47,623
2019-06-05 11:00:00,59,354,35,35,47,94,70,23,717
2019-06-05 12:00:00,224,177,23,23,94,94,224,59,918
2019-06-05 13:00:00,200,177,35,47,59,141,141,106,906
2019-06-05 14:00:00,141,106,35,23,59,129,212,47,752
2019-06-05 15:00:00,165,47,47,0,11,47,224,47,588
2019-06-05 16:00:00,165,94,11,0,11,35,129,35,480
2019-06-05 17:00:00,94,47,11,11,0,23,129,11,326
2019-06-05 18:00:00,94,35,11,11,11,23,129,59,373
2019-06-05 19:00:00,59,70,11,11,35,94,23,35,338
2019-06-05 20:00:00,70,47,11,23,0,70,82,0,303
2019-06-05 21:00:00,35,0,11,11,11,23,35,11,137
2019-06-05 22:00:00,11,23,0,0,35,47,35,11,162
2019-06-05 23:00:00,35,23,11,0,11,0,23,11,114
2019-06-06 00:00:00,23,0,0,0,0,11,11,0,45
2019-06-06 01:00:00,11,0,0,0,0,0,0,0,11
2019-06-06 02:00:00,0,0,11,0,0,0,0,0,11
2019-06-06 03:00:00,0,0,0,0,0,0,0,0,0
2019-06-06 04:00:00,11,0,0,0,0,0,0,0,11
2019-06-06 05:00:00,11,0,0,0,0,0,0,11,22
2019-06-06 06:00:00,47,11,0,0,0,0,59,11,128
2019-06-06 07:00:00,94,47,11,0,0,0,0,35,187
2019-06-06 08:00:00,70,59,59,11,0,0,94,59,352
2019-06-06 09:00:00,129,59,35,0,11,11,47,35,327
2019-06-06 10:00:00,153,153,23,35,35,177,188,82,846
2019-06-06 11:00:00,495,153,35,23,35,59,259,11,1070
2019-06-06 12:00:00,153,118,11,23,11,23,224,0,563
2019-06-06 13:00:00,106,236,0,11,23,94,200,0,670
2019-06-06 14:00:00,212,59,23,11,11,47,200,59,622
2019-06-06 15:00:00,106,11,0,0,23,47,118,11,316
2019-06-06 16:00:00,129,35,35,11,47,11,82,35,385
2019-06-06 17:00:00,106,11,35,0,23,47,106,11,339
2019-06-06 18:00:00,177,35,23,11,23,23,94,59,445
2019-06-06 19:00:00,82,23,11,11,23,47,82,35,314
2019-06-06 20:00:00,11,35,11,0,23,35,59,23,197
2019-06-06 21:00:00,94,59,11,0,11,11,106,11,303
2019-06-06 22:00:00,11,11,0,0,0,11,59,23,115
2019-06-06 23:00:00,11,23,0,0,0,11,47,11,103
2019-06-07 00:00:00,11,0,0,0,0,0,0,11,22
2019-06-07 01:00:00,0,0,0,0,0,0,0,0,0
2019-06-07 02:00:00,0,0,0,0,0,0,35,0,35
2019-06-07 03:00:00,0,0,0,0,0,0,0,0,0
2019-06-07 04:00:00,0,0,0,0,0,0,0,0,0
2019-06-07 05:00:00,11,0,0,0,0,0,0,11,22
2019-06-07 06:00:00,23,11,11,0,0,11,23,23,102
2019-06-07 07:00:00,82,11,0,0,0,11,11,47,162
2019-06-07 08:00:00,94,35,0,0,35,0,11,106,281
2019-06-07 09:00:00,94,23,0,0,23,0,47,23,210
2019-06-07 10:00:00,106,165,11,35,11,23,271,11,633
2019-06-07 11:00:00,165,236,11,47,11,82,165,0,717
2019-06-07 12:00:00,283,141,11,23,35,59,295,35,882
2019-06-07 13:00:00,212,177,11,11,47,59,259,70,846
2019-06-07 14:00:00,236,94,11,35,11,35,389,59,870
2019-06-07 15:00:00,200,236,11,11,23,35,177,0,693
2019-06-07 16:00:00,82,118,23,11,0,23,153,23,433
2019-06-07 17:00:00,106,82,23,23,47,23,177,0,481
2019-06-07 18:00:00,106,82,11,35,0,11,129,11,385
2019-06-07 19:00:00,224,141,0,35,0,0,118,165,683
2019-06-07 20:00:00,141,153,0,11,11,11,70,11,408
2019-06-07 21:00:00,47,23,0,23,11,11,94,0,209
2019-06-07 22:00:00,82,23,35,35,11,23,70,0,279
2019-06-07 23:00:00,0,11,0,23,0,35,47,11,127
2019-06-08 00:00:00,11,59,23,0,0,35,35,0,163
2019-06-08 01:00:00,0,0,0,0,0,35,35,0,70
2019-06-08 02:00:00,47,0,0,0,0,11,23,0,81
2019-06-08 03:00:00,11,0,0,0,0,0,11,0,22
2019-06-08 04:00:00,0,0,0,0,0,0,23,0,23
2019-06-08 05:00:00,0,0,0,0,0,0,35,0,35
2019-06-08 06:00:00,0,0,0,0,0,0,47,0,47
2019-06-08 07:00:00,11,11,0,11,0,0,70,0,103
2019-06-08 08:00:00,23,59,0,23,0,11,35,0,151
2019-06-08 09:00:00,23,94,11,47,0,23,59,47,304
2019-06-08 10:00:00,118,224,23,153,35,94,177,35,859
2019-06-08 11:00:00,212,283,70,70,23,82,861,47,1648
2019-06-08 12:00:00,188,188,59,47,23,141,413,0,1059
2019-06-08 13:00:00,318,318,11,0,23,94,531,11,1306
2019-06-08 14:00:00,224,755,23,0,35,236,11,35,1319
2019-06-08 15:00:00,165,306,23,0,118,177,0,59,848
2019-06-08 16:00:00,200,342,11,0,141,94,0,0,788
2019-06-08 17:00:00,342,377,47,0,47,129,0,59,1001
2019-06-08 18:00:00,295,295,35,0,0,94,0,11,730
2019-06-08 19:00:00,106,188,47,0,11,35,0,11,398
2019-06-08 20:00:00,153,106,11,0,0,23,0,11,304
2019-06-08 21:00:00,271,306,11,0,0,23,0,23,634
2019-06-08 22:00:00,306,23,0,0,0,0,0,35,364
2019-06-08 23:00:00,23,11,0,0,0,0,0,0,34
2019-06-09 00:00:00,35,11,0,0,0,0,0,11,57
2019-06-09 01:00:00,11,11,0,0,0,0,11,0,33
2019-06-09 02:00:00,11,11,0,0,0,0,0,0,22
2019-06-09 03:00:00,0,11,0,0,0,0,0,0,11
2019-06-09 04:00:00,0,0,0,0,0,0,0,0,0
2019-06-09 05:00:00,0,11,0,0,0,0,11,0,22
2019-06-09 06:00:00,0,0,0,0,0,0,11,0,11
2019-06-09 07:00:00,35,35,0,0,0,0,23,0,93
2019-06-09 08:00:00,0,11,23,0,0,0,23,0,57
2019-06-09 09:00:00,47,35,11,0,0,11,35,11,150
2019-06-09 10:00:00,82,82,0,0,35,47,118,0,364
2019-06-09 11:00:00,106,401,0,0,47,23,224,35,836
2019-06-09 12:00:00,177,389,35,0,106,82,342,47,1178
2019-06-09 13:00:00,377,472,106,0,59,129,637,23,1803
2019-06-09 14:00:00,165,365,70,0,106,118,885,82,1791
2019-06-09 15:00:00,224,413,106,0,94,106,672,35,1650
2019-06-09 16:00:00,177,330,59,0,153,177,649,59,1604
2019-06-09 17:00:00,271,295,23,0,35,35,295,23,977
2019-06-09 18:00:00,212,295,47,0,23,35,200,47,859
2019-06-09 19:00:00,106,94,11,0,35,47,129,47,469
2019-06-09 20:00:00,141,106,59,0,23,47,106,23,505
2019-06-09 21:00:00,59,47,59,0,0,35,94,0,294
2019-06-09 22:00:00,59,59,0,0,0,0,82,0,200
2019-06-09 23:00:00,11,11,23,0,11,0,59,0,115
2019-06-10 00:00:00,0,0,0,0,11,23,59,0,93
2019-06-10 01:00:00,35,0,11,0,0,0,59,0,105
2019-06-10 02:00:00,11,0,0,0,0,11,11,0,33
2019-06-10 03:00:00,0,0,0,0,0,0,23,0,23
2019-06-10 04:00:00,0,0,0,0,0,0,35,0,35
2019-06-10 05:00:00,0,0,0,0,0,0,11,0,11
2019-06-10 06:00:00,0,0,0,0,0,0,35,0,35
2019-06-10 07:00:00,0,11,0,0,11,11,11,0,44
2019-06-10 08:00:00,11,47,0,0,11,0,59,11,139
2019-06-10 09:00:00,35,70,129,0,11,11,82,0,338
2019-06-10 10:00:00,47,94,495,0,35,47,141,23,882
2019-06-10 11:00:00,200,483,1109,0,82,118,483,35,2510
2019-06-10 12:00:00,342,330,1345,0,118,129,778,118,3160
2019-06-10 13:00:00,354,472,1121,0,141,236,849,70,3243
2019-06-10 14:00:00,247,566,767,0,141,212,755,35,2723
2019-06-10 15:00:00,306,330,118,0,129,318,731,82,2014
2019-06-10 16:00:00,177,259,94,0,141,70,424,59,1224
2019-06-10 17:00:00,200,200,47,0,23,82,236,47,835
2019-06-10 18:00:00,460,200,23,0,11,106,94,11,905
2019-06-10 19:00:00,118,59,23,0,23,35,188,23,469
2019-06-10 20:00:00,35,23,47,0,0,11,59,0,175
2019-06-10 21:00:00,11,11,11,0,11,11,23,23,101
2019-06-10 22:00:00,0,23,0,0,0,0,23,0,46
2019-06-10 23:00:00,23,35,0,0,0,0,47,11,116
2019-06-11 00:00:00,11,11,0,0,0,0,35,0,57
2019-06-11 01:00:00,0,0,0,0,0,0,35,0,35
2019-06-11 02:00:00,0,0,0,0,0,0,23,0,23
2019-06-11 03:00:00,0,0,0,0,0,0,23,0,23
2019-06-11 04:00:00,0,0,0,0,0,0,11,0,11
2019-06-11 05:00:00,11,11,0,0,0,0,47,0,69
2019-06-11 06:00:00,47,0,0,0,0,0,47,11,105
2019-06-11 07:00:00,129,47,0,0,0,0,47,23,246
2019-06-11 08:00:00,70,35,0,0,0,0,23,59,187
2019-06-11 09:00:00,82,59,23,0,0,11,70,23,268
2019-06-11 10:00:00,70,82,11,0,11,35,141,23,373
2019-06-11 11:00:00,129,129,23,0,47,141,401,11,881
2019-06-11 12:00:00,212,118,11,0,47,106,448,82,1024
2019-06-11 13:00:00,177,306,11,0,47,94,236,94,965
2019-06-11 14:00:00,295,247,35,0,35,165,271,224,1272
2019-06-11 15:00:00,295,295,23,0,70,129,188,59,1059
2019-06-11 16:00:00,271,47,47,0,11,47,82,0,505
2019-06-11 17:00:00,70,35,35,0,11,0,70,0,221
2019-06-11 18:00:00,70,23,35,0,11,11,70,23,243
2019-06-11 19:00:00,59,94,23,0,11,0,59,11,257
2019-06-11 20:00:00,47,0,0,0,11,0,23,0,81
2019-06-11 21:00:00,11,35,23,0,11,0,94,0,174
2019-06-11 22:00:00,0,0,0,0,0,0,23,0,23
2019-06-11 23:00:00,0,11,0,0,0,0,11,0,22
2019-06-12 00:00:00,0,0,0,0,0,0,11,0,11
2019-06-12 01:00:00,0,0,0,0,0,0,0,0,0
2019-06-12 02:00:00,0,0,0,0,0,0,0,0,0
2019-06-12 03:00:00,0,0,0,0,0,0,23,11,34
2019-06-12 04:00:00,0,0,0,0,0,0,0,0,0
2019-06-12 05:00:00,23,0,0,0,0,0,0,11,34
2019-06-12 06:00:00,59,11,0,0,0,0,0,0,70
2019-06-12 07:00:00,94,0,0,0,0,23,35,11,163
2019-06-12 08:00:00,59,23,11,0,47,11,47,82,280
2019-06-12 09:00:00,200,70,0,0,0,11,35,0,316
2019-06-12 10:00:00,283,177,47,0,23,11,118,23,682
2019-06-12 11:00:00,141,94,35,0,59,141,295,47,812
2019-06-12 12:00:00,188,165,70,0,23,94,177,11,728
2019-06-12 13:00:00,236,330,70,0,35,59,236,35,1001
2019-06-12 14:00:00,188,106,11,0,118,177,200,82,882
2019-06-12 15:00:00,129,106,35,0,23,82,271,11,657
2019-06-12 16:00:00,59,129,23,0,11,23,153,23,421
2019-06-12 17:00:00,35,47,23,0,11,47,94,0,257
2019-06-12 18:00:00,47,23,23,0,11,11,35,47,197
2019-06-12 19:00:00,59,0,23,0,23,59,82,11,257
2019-06-12 20:00:00,35,59,11,0,11,35,35,11,197
2019-06-12 21:00:00,47,23,0,0,0,11,11,0,92
2019-06-12 22:00:00,82,11,0,0,11,35,23,11,173
2019-06-12 23:00:00,11,23,11,0,0,0,11,11,67
2019-06-13 00:00:00,11,0,0,0,0,0,11,0,22
2019-06-13 01:00:00,11,0,0,0,0,0,0,0,11
2019-06-13 02:00:00,23,0,0,0,0,0,11,0,34
2019-06-13 03:00:00,0,0,0,0,0,0,0,0,0
2019-06-13 04:00:00,0,0,0,0,0,0,0,0,0
2019-06-13 05:00:00,47,0,0,0,0,0,0,11,58
2019-06-13 06:00:00,23,47,0,0,0,0,35,11,116
2019-06-13 07:00:00,82,35,0,0,0,11,47,0,175
2019-06-13 08:00:00,82,47,0,0,0,11,35,70,245
2019-06-13 09:00:00,35,47,11,0,0,11,70,23,197
2019-06-13 10:00:00,94,70,11,0,35,59,70,47,386
2019-06-13 11:00:00,247,35,23,0,23,35,283,0,646
2019-06-13 12:00:00,165,118,35,0,0,141,330,35,824
2019-06-13 13:00:00,94,118,82,0,35,94,519,35,977
2019-06-13 14:00:00,188,94,94,0,0,70,1121,23,1590
2019-06-13 15:00:00,212,106,94,0,11,35,247,23,728
2019-06-13 16:00:00,106,82,59,0,23,94,188,47,599
2019-06-13 17:00:00,47,106,82,0,0,59,200,35,529
2019-06-13 18:00:00,59,47,70,0,11,11,106,35,339
2019-06-13 19:00:00,106,59,59,0,0,59,35,23,341
2019-06-13 20:00:00,118,35,59,0,35,94,70,23,434
2019-06-13 21:00:00,47,35,35,0,23,47,23,11,221
2019-06-13 22:00:00,59,0,11,0,11,35,47,11,174
2019-06-13 23:00:00,11,0,23,0,0,0,11,11,56
2019-06-14 00:00:00,0,0,0,0,0,11,11,11,33
2019-06-14 01:00:00,11,11,0,0,0,0,0,11,33
2019-06-14 02:00:00,11,0,0,0,0,0,0,0,11
2019-06-14 03:00:00,0,11,0,0,0,0,0,0,11
2019-06-14 04:00:00,0,0,0,0,0,0,0,0,0
2019-06-14 05:00:00,35,0,0,0,0,0,0,11,46
2019-06-14 06:00:00,59,11,0,0,0,11,35,35,151
2019-06-14 07:00:00,59,0,0,0,0,0,59,0,118
2019-06-14 08:00:00,23,11,35,0,0,11,47,47,174
2019-06-14 09:00:00,153,11,129,0,59,47,826,0,1225
2019-06-14 10:00:00,188,188,153,0,23,0,590,23,1165
2019-06-14 11:00:00,247,47,23,0,35,47,224,59,682
2019-06-14 12:00:00,141,177,118,0,35,47,224,59,801
2019-06-14 13:00:00,177,188,47,0,23,70,236,59,800
2019-06-14 14:00:00,247,82,47,0,35,82,200,82,775
2019-06-14 15:00:00,283,47,23,0,59,70,247,70,799
2019-06-14 16:00:00,82,188,35,0,59,200,212,23,799
2019-06-14 17:00:00,165,212,613,0,23,106,236,47,1402
2019-06-14 18:00:00,224,106,625,0,23,82,141,47,1248
2019-06-14 19:00:00,106,23,23,0,11,59,94,35,351
2019-06-14 20:00:00,59,47,11,0,11,47,82,23,280
2019-06-14 21:00:00,47,0,59,0,0,47,23,11,187
2019-06-14 22:00:00,59,47,94,0,11,59,70,0,340
2019-06-14 23:00:00,35,23,70,0,0,35,70,35,268
2019-06-15 00:00:00,23,23,23,0,0,23,35,0,127
2019-06-15 01:00:00,23,11,23,0,11,11,23,0,102
2019-06-15 02:00:00,129,0,0,0,0,11,23,0,163
2019-06-15 03:00:00,0,0,11,0,11,11,0,0,33
2019-06-15 04:00:00,11,11,0,0,0,0,0,0,22
2019-06-15 05:00:00,0,0,0,0,0,0,0,0,0
2019-06-15 06:00:00,0,0,0,0,0,0,0,0,0
2019-06-15 07:00:00,23,11,0,0,0,0,23,11,68
2019-06-15 08:00:00,0,47,11,0,0,0,23,11,92
2019-06-15 09:00:00,23,106,11,0,0,141,94,0,375
2019-06-15 10:00:00,35,106,47,0,11,70,129,0,398
2019-06-15 11:00:00,236,212,82,0,47,106,342,35,1060
2019-06-15 12:00:00,448,413,35,0,70,129,708,35,1838
2019-06-15 13:00:00,236,330,35,0,94,330,601,59,1685
2019-06-15 14:00:00,460,389,23,0,141,318,507,59,1897
2019-06-15 15:00:00,342,224,70,0,94,141,507,11,1389
2019-06-15 16:00:00,306,129,106,0,59,188,436,11,1235
2019-06-15 17:00:00,188,177,70,0,23,70,283,47,858
2019-06-15 18:00:00,82,23,47,0,35,129,129,35,480
2019-06-15 19:00:00,129,59,106,0,11,23,59,23,410
2019-06-15 20:00:00,118,47,59,0,23,47,118,0,412
2019-06-15 21:00:00,47,47,82,0,11,47,47,0,281
2019-06-15 22:00:00,47,35,82,0,0,70,82,0,316
2019-06-15 23:00:00,47,11,59,0,0,11,11,35,174
2019-06-16 00:00:00,11,47,94,0,11,47,23,23,256
2019-06-16 01:00:00,23,47,35,0,23,23,47,11,209
2019-06-16 02:00:00,11,0,0,0,23,11,59,23,127
2019-06-16 03:00:00,11,0,0,0,0,11,59,0,81
2019-06-16 04:00:00,0,0,0,0,0,0,35,0,35
2019-06-16 05:00:00,0,0,0,0,0,0,23,0,23
2019-06-16 06:00:00,11,0,0,0,0,0,11,0,22
2019-06-16 07:00:00,11,0,0,0,0,0,23,0,34
2019-06-16 08:00:00,11,11,0,0,0,0,106,11,139
2019-06-16 09:00:00,35,35,23,0,0,0,106,11,210
2019-06-16 10:00:00,47,0,11,0,11,23,35,23,150
2019-06-16 11:00:00,47,70,35,0,23,94,165,0,434
2019-06-16 12:00:00,200,106,23,0,47,153,318,70,917
2019-06-16 13:00:00,118,542,47,0,47,177,424,35,1390
2019-06-16 14:00:00,106,188,0,0,59,165,389,23,930
2019-06-16 15:00:00,177,141,11,0,47,165,295,70,906
2019-06-16 16:00:00,94,165,11,0,59,118,236,23,706
2019-06-16 17:00:00,106,23,23,0,0,35,247,0,434
2019-06-16 18:00:00,118,47,0,0,23,70,70,23,351
2019-06-16 19:00:00,70,59,11,0,23,11,59,0,233
2019-06-16 20:00:00,0,23,0,0,11,35,59,23,151
2019-06-16 21:00:00,23,35,0,0,0,23,0,0,81
2019-06-16 22:00:00,23,23,0,0,0,0,0,0,46
2019-06-16 23:00:00,0,11,0,0,11,11,0,0,33
2019-06-17 00:00:00,11,47,11,0,0,11,23,0,103
2019-06-17 01:00:00,11,0,11,0,0,0,11,11,44
2019-06-17 02:00:00,0,11,0,0,0,0,0,0,11
2019-06-17 03:00:00,0,0,0,0,0,0,11,0,11
2019-06-17 04:00:00,0,0,0,0,0,0,0,0,0
2019-06-17 05:00:00,11,0,0,0,0,0,0,0,11
2019-06-17 06:00:00,70,0,0,0,11,0,0,11,92
2019-06-17 07:00:00,118,11,0,0,11,23,11,35,209
2019-06-17 08:00:00,212,35,0,0,0,11,23,106,387
2019-06-17 09:00:00,236,23,106,0,11,35,70,118,599
2019-06-17 10:00:00,342,47,165,0,11,47,141,11,764
2019-06-17 11:00:00,188,118,118,0,35,94,224,11,788
2019-06-17 12:00:00,200,141,141,0,59,82,306,11,940
2019-06-17 13:00:00,306,59,47,0,23,153,354,82,1024
2019-06-17 14:00:00,259,70,0,0,23,70,212,94,728
2019-06-17 15:00:00,259,507,82,0,0,106,165,82,1201
2019-06-17 16:00:00,153,70,23,0,23,35,141,23,468
2019-06-17 17:00:00,165,23,106,0,11,129,177,11,622
2019-06-17 18:00:00,82,82,47,0,0,70,59,82,422
2019-06-17 19:00:00,271,59,23,0,23,129,59,0,564
2019-06-17 20:00:00,94,47,47,0,11,47,35,23,304
2019-06-17 21:00:00,23,11,0,0,11,23,11,11,90
2019-06-17 22:00:00,47,11,11,0,0,23,0,11,103
2019-06-17 23:00:00,118,0,0,0,0,11,11,11,151
2019-06-18 00:00:00,0,0,0,0,0,0,11,0,11
2019-06-18 01:00:00,0,0,0,0,0,0,11,0,11
2019-06-18 02:00:00,0,0,0,0,0,0,0,0,0
2019-06-18 03:00:00,0,0,0,0,0,0,0,0,0
2019-06-18 04:00:00,0,0,0,0,0,0,11,0,11
2019-06-18 05:00:00,11,0,0,0,0,0,0,0,11
2019-06-18 06:00:00,47,11,0,0,0,11,47,0,116
2019-06-18 07:00:00,106,35,0,0,11,11,35,35,233
2019-06-18 08:00:00,141,23,35,0,0,11,35,70,315
2019-06-18 09:00:00,94,106,23,0,11,23,59,11,327
2019-06-18 10:00:00,224,59,23,0,35,47,212,11,611
2019-06-18 11:00:00,141,118,165,0,82,118,295,23,942
2019-06-18 12:00:00,236,224,0,0,23,118,413,82,1096
2019-06-18 13:00:00,306,118,35,0,23,106,271,23,882
2019-06-18 14:00:00,212,118,106,0,11,106,200,47,800
2019-06-18 15:00:00,212,59,59,0,23,70,177,11,611
2019-06-18 16:00:00,141,129,47,0,35,47,495,11,905
2019-06-18 17:00:00,129,106,11,0,59,82,141,47,575
2019-06-18 18:00:00,141,106,11,0,23,59,59,47,446
2019-06-18 19:00:00,70,70,59,0,47,106,118,11,481
2019-06-18 20:00:00,47,118,23,0,47,47,165,23,470
2019-06-18 21:00:00,70,118,23,0,35,23,141,23,433
2019-06-18 22:00:00,35,0,11,0,35,23,35,23,162
2019-06-18 23:00:00,0,0,0,0,23,47,23,23,116
2019-06-19 00:00:00,11,0,0,0,11,35,47,0,104
2019-06-19 01:00:00,23,0,11,0,0,0,0,0,34
2019-06-19 02:00:00,0,0,0,0,0,0,11,11,22
2019-06-19 03:00:00,0,0,0,0,0,0,0,0,0
2019-06-19 04:00:00,0,11,0,0,0,0,0,0,11
2019-06-19 05:00:00,11,0,0,0,0,0,0,0,11
2019-06-19 06:00:00,70,11,0,0,0,0,70,23,174
2019-06-19 07:00:00,47,23,0,0,0,23,11,35,139
2019-06-19 08:00:00,118,11,0,0,11,0,35,70,245
2019-06-19 09:00:00,129,70,35,0,0,11,82,47,374
2019-06-19 10:00:00,129,82,59,0,23,35,106,47,481
2019-06-19 11:00:00,224,944,47,0,47,70,295,47,1674
2019-06-19 12:00:00,224,259,59,0,70,141,259,70,1082
2019-06-19 13:00:00,401,354,70,0,70,424,554,70,1943
2019-06-19 14:00:00,236,413,35,0,0,70,896,11,1661
2019-06-19 15:00:00,236,200,35,0,47,47,306,23,894
2019-06-19 16:00:00,330,271,11,0,11,59,306,59,1047
2019-06-19 17:00:00,82,106,47,0,35,70,141,35,516
2019-06-19 18:00:00,118,153,47,0,0,59,82,23,482
2019-06-19 19:00:00,59,23,47,0,35,82,94,0,340
2019-06-19 20:00:00,11,47,23,0,0,35,59,11,186
2019-06-19 21:00:00,35,0,11,0,0,11,11,11,79
2019-06-19 22:00:00,23,0,11,0,0,0,0,11,45
2019-06-19 23:00:00,23,0,0,0,0,0,23,11,57
2019-06-20 00:00:00,0,0,0,0,0,0,11,11,22
2019-06-20 01:00:00,0,0,0,0,0,35,23,0,58
2019-06-20 02:00:00,11,0,0,0,0,0,0,23,34
2019-06-20 03:00:00,0,0,0,0,0,0,0,0,0
2019-06-20 04:00:00,0,0,11,0,0,0,0,0,11
2019-06-20 05:00:00,35,0,0,0,0,0,0,11,46
2019-06-20 06:00:00,35,23,0,0,0,11,47,11,127
2019-06-20 07:00:00,94,0,0,0,11,11,82,0,198
2019-06-20 08:00:00,141,11,23,0,11,23,129,47,385
2019-06-20 09:00:00,47,23,23,0,0,23,118,23,257
2019-06-20 10:00:00,94,23,70,0,35,23,165,0,410
2019-06-20 11:00:00,35,35,11,0,23,82,165,23,374
2019-06-20 12:00:00,94,82,35,0,11,47,118,11,398
2019-06-20 13:00:00,153,94,35,0,23,70,118,23,516
2019-06-20 14:00:00,224,94,47,0,23,70,188,47,693
2019-06-20 15:00:00,200,271,82,0,11,59,118,23,764
2019-06-20 16:00:00,141,106,94,0,35,118,129,11,634
2019-06-20 17:00:00,177,106,11,0,35,94,59,47,529
2019-06-20 18:00:00,106,70,11,0,11,35,59,11,303
2019-06-20 19:00:00,70,35,47,0,23,11,59,11,256
2019-06-20 20:00:00,47,0,35,0,11,11,59,11,174
2019-06-20 21:00:00,23,11,11,0,0,23,59,11,138
2019-06-20 22:00:00,35,23,23,0,0,0,35,23,139
2019-06-20 23:00:00,0,11,0,0,0,0,35,0,46
2019-06-21 00:00:00,23,0,11,0,11,0,11,11,67
2019-06-21 01:00:00,0,0,0,0,0,0,35,11,46
2019-06-21 02:00:00,0,11,23,0,0,0,23,0,57
2019-06-21 03:00:00,0,0,11,0,0,11,35,0,57
2019-06-21 04:00:00,0,0,11,0,0,0,11,0,22
2019-06-21 05:00:00,11,0,11,0,0,0,23,0,45
2019-06-21 06:00:00,47,11,11,0,11,0,118,0,198
2019-06-21 07:00:00,47,59,11,0,0,0,82,47,246
2019-06-21 08:00:00,94,59,11,0,23,0,59,106,352
2019-06-21 09:00:00,70,70,47,0,35,0,35,11,268
2019-06-21 10:00:00,94,106,35,0,0,59,129,35,458
2019-06-21 11:00:00,330,118,47,0,11,106,283,70,965
2019-06-21 12:00:00,259,165,23,0,11,70,295,70,893
2019-06-21 13:00:00,165,82,59,0,11,70,295,35,717
2019-06-21 14:00:00,94,106,35,0,11,47,306,47,646
2019-06-21 15:00:00,448,153,59,0,59,70,259,23,1071
2019-06-21 16:00:00,236,59,70,0,23,94,200,0,682
2019-06-21 17:00:00,212,129,106,0,11,59,224,11,752
2019-06-21 18:00:00,129,82,94,0,35,129,118,23,610
2019-06-21 19:00:00,118,35,59,0,35,94,59,47,447
2019-06-21 20:00:00,70,129,59,0,23,106,94,70,551
2019-06-21 21:00:00,188,35,118,0,82,70,82,23,598
2019-06-21 22:00:00,70,23,70,0,23,70,82,23,361
2019-06-21 23:00:00,94,11,0,0,11,59,23,11,209
2019-06-22 00:00:00,70,0,59,0,11,35,23,23,221
2019-06-22 01:00:00,11,0,0,0,11,0,11,0,33
2019-06-22 02:00:00,0,23,0,0,0,0,23,0,46
2019-06-22 03:00:00,0,0,11,0,0,0,0,0,11
2019-06-22 04:00:00,0,0,0,0,0,0,11,0,11
2019-06-22 05:00:00,0,0,0,0,0,0,35,0,35
2019-06-22 06:00:00,0,0,0,0,0,0,47,0,47
2019-06-22 07:00:00,0,0,0,0,0,0,11,0,11
2019-06-22 08:00:00,11,23,11,0,0,0,47,0,92
2019-06-22 09:00:00,35,23,0,0,11,35,118,0,222
2019-06-22 10:00:00,70,141,70,0,11,35,236,47,610
2019-06-22 11:00:00,236,436,177,0,47,47,472,23,1438
2019-06-22 12:00:00,306,342,59,0,106,153,814,70,1850
2019-06-22 13:00:00,377,424,106,0,59,236,1144,47,2393
2019-06-22 14:00:00,318,578,70,0,94,318,885,70,2333
2019-06-22 15:00:00,306,354,59,0,118,295,696,47,1875
2019-06-22 16:00:00,342,283,82,0,47,283,472,94,1603
2019-06-22 17:00:00,247,224,11,0,35,259,306,35,1117
2019-06-22 18:00:00,236,82,94,0,47,141,165,47,812
2019-06-22 19:00:00,212,70,59,0,35,153,35,35,599
2019-06-22 20:00:00,165,59,70,0,35,129,35,11,504
2019-06-22 21:00:00,141,59,23,0,35,106,47,35,446
2019-06-22 22:00:00,129,11,47,0,59,82,47,23,398
2019-06-22 23:00:00,118,11,23,0,59,59,47,23,340
2019-06-23 00:00:00,129,35,35,0,35,47,23,35,339
2019-06-23 01:00:00,11,0,23,0,23,35,23,11,126
2019-06-23 02:00:00,47,59,0,0,0,11,23,11,151
2019-06-23 03:00:00,11,0,0,0,0,23,23,0,57
2019-06-23 04:00:00,11,0,0,0,11,0,11,0,33
2019-06-23 05:00:00,0,0,0,0,0,0,0,0,0
2019-06-23 06:00:00,0,0,0,0,0,0,0,0,0
2019-06-23 07:00:00,0,11,0,0,0,0,11,0,22
2019-06-23 08:00:00,0,0,0,0,0,0,23,0,23
2019-06-23 09:00:00,23,35,11,0,11,11,236,11,338
2019-06-23 10:00:00,82,47,23,0,35,82,59,0,328
2019-06-23 11:00:00,59,188,23,0,0,94,295,35,694
2019-06-23 12:00:00,212,165,59,0,106,224,719,59,1544
2019-06-23 13:00:00,177,295,47,0,59,153,566,106,1403
2019-06-23 14:00:00,283,283,35,0,129,224,542,47,1543
2019-06-23 15:00:00,283,200,47,0,35,224,483,106,1378
2019-06-23 16:00:00,306,212,35,0,35,129,365,35,1117
2019-06-23 17:00:00,295,82,23,0,47,106,224,11,788
2019-06-23 18:00:00,70,82,23,0,35,11,82,0,303
2019-06-23 19:00:00,118,141,47,0,11,35,94,70,516
2019-06-23 20:00:00,35,47,35,0,23,106,47,47,340
2019-06-23 21:00:00,11,47,11,0,11,11,23,11,125
2019-06-23 22:00:00,11,0,23,0,0,11,23,35,103
2019-06-23 23:00:00,0,0,23,0,0,0,0,0,23
2019-06-24 00:00:00,0,0,11,0,0,11,0,0,22
2019-06-24 01:00:00,0,0,0,0,0,0,0,0,0
2019-06-24 02:00:00,0,0,11,0,0,0,0,0,11
2019-06-24 03:00:00,11,0,0,0,0,0,0,0,11
2019-06-24 04:00:00,0,0,0,0,0,0,0,0,0
2019-06-24 05:00:00,0,0,0,0,0,0,0,0,0
2019-06-24 06:00:00,35,47,0,0,11,11,23,11,138
2019-06-24 07:00:00,59,11,0,0,11,11,11,47,150
2019-06-24 08:00:00,106,23,0,0,47,11,35,82,304
2019-06-24 09:00:00,82,11,0,0,0,11,59,0,163
2019-06-24 10:00:00,106,106,0,0,11,23,188,35,469
2019-06-24 11:00:00,129,389,0,0,11,47,165,23,764
2019-06-24 12:00:00,200,649,0,0,23,82,401,47,1402
2019-06-24 13:00:00,236,448,0,0,70,165,354,35,1308
2019-06-24 14:00:00,318,684,0,0,82,271,295,23,1673
2019-06-24 15:00:00,247,389,0,0,35,165,295,23,1154
2019-06-24 16:00:00,283,212,0,0,11,23,318,0,847
2019-06-24 17:00:00,295,118,0,0,23,59,153,11,659
2019-06-24 18:00:00,141,59,0,0,11,35,129,47,422
2019-06-24 19:00:00,188,59,0,0,23,35,82,35,422
2019-06-24 20:00:00,94,35,0,0,11,0,59,11,210
2019-06-24 21:00:00,59,23,0,0,0,0,47,35,164
2019-06-24 22:00:00,11,11,0,0,11,11,23,11,78
2019-06-24 23:00:00,0,0,0,0,0,0,0,0,0
2019-06-25 00:00:00,23,11,0,0,0,0,0,0,34
2019-06-25 01:00:00,0,0,11,0,0,0,0,0,11
2019-06-25 02:00:00,0,11,0,0,0,0,11,0,22
2019-06-25 03:00:00,0,0,0,0,0,0,0,0,0
2019-06-25 04:00:00,11,11,0,0,0,0,0,0,22
2019-06-25 05:00:00,11,0,0,0,0,0,23,0,34
2019-06-25 06:00:00,70,23,0,0,0,11,23,23,150
2019-06-25 07:00:00,70,35,11,0,0,0,11,11,138
2019-06-25 08:00:00,106,11,23,0,0,11,35,82,268
2019-06-25 09:00:00,106,94,23,0,11,23,47,0,304
2019-06-25 10:00:00,70,129,23,0,47,35,212,11,527
2019-06-25 11:00:00,188,259,11,0,59,118,389,59,1083
2019-06-25 12:00:00,342,212,35,0,82,200,365,35,1271
2019-06-25 13:00:00,413,495,82,0,70,188,247,59,1554
2019-06-25 14:00:00,129,566,35,0,82,94,283,0,1189
2019-06-25 15:00:00,224,495,47,0,35,141,295,47,1284
2019-06-25 16:00:00,165,283,47,0,47,153,259,35,989
2019-06-25 17:00:00,188,82,47,0,23,47,224,11,622
2019-06-25 18:00:00,118,106,11,0,94,129,106,11,575
2019-06-25 19:00:00,47,82,11,0,35,118,82,23,398
2019-06-25 20:00:00,70,47,23,0,23,35,94,59,351
2019-06-25 21:00:00,141,70,11,0,23,35,35,118,433
2019-06-25 22:00:00,35,0,0,0,0,0,23,0,58
2019-06-25 23:00:00,23,0,0,0,11,0,23,23,80
2019-06-26 00:00:00,0,23,0,0,0,0,23,11,57
2019-06-26 01:00:00,11,11,0,0,0,0,0,0,22
2019-06-26 02:00:00,11,0,0,0,0,0,11,0,22
2019-06-26 03:00:00,0,0,0,0,0,0,0,0,0
2019-06-26 04:00:00,0,0,0,0,0,0,11,0,11
2019-06-26 05:00:00,11,0,0,0,0,0,11,0,22
2019-06-26 06:00:00,47,23,0,0,0,0,11,0,81
2019-06-26 07:00:00,94,47,0,0,0,11,0,11,163
2019-06-26 08:00:00,47,35,0,0,0,35,11,35,163
2019-06-26 09:00:00,70,70,0,0,11,0,59,11,221
2019-06-26 10:00:00,82,118,11,0,59,35,59,11,375
2019-06-26 11:00:00,165,200,0,0,35,35,153,59,647
2019-06-26 12:00:00,165,944,0,0,0,153,247,70,1579
2019-06-26 13:00:00,153,1380,35,0,82,94,295,47,2086
2019-06-26 14:00:00,188,637,106,0,23,118,460,70,1602
2019-06-26 15:00:00,236,684,35,0,70,188,295,59,1567
2019-06-26 16:00:00,188,165,59,0,23,82,177,23,717
2019-06-26 17:00:00,200,94,23,0,23,70,165,35,610
2019-06-26 18:00:00,283,141,35,0,0,35,188,11,693
2019-06-26 19:00:00,70,70,59,0,0,70,59,35,363
2019-06-26 20:00:00,82,11,11,0,47,23,94,70,338
2019-06-26 21:00:00,59,23,23,0,23,47,59,0,234
2019-06-26 22:00:00,35,11,11,0,0,70,59,23,209
2019-06-26 23:00:00,11,23,0,0,0,0,47,23,104
2019-06-27 00:00:00,11,11,0,0,0,11,0,0,33
2019-06-27 01:00:00,0,0,0,0,0,0,0,0,0
2019-06-27 02:00:00,35,0,0,0,11,0,0,11,57
2019-06-27 03:00:00,0,0,0,0,0,0,23,0,23
2019-06-27 04:00:00,0,0,0,0,0,0,11,0,11
2019-06-27 05:00:00,11,0,0,0,0,0,11,11,33
2019-06-27 06:00:00,70,11,0,0,0,0,70,0,151
2019-06-27 07:00:00,59,35,0,0,0,35,11,35,175
2019-06-27 08:00:00,106,35,0,0,11,0,23,47,222
2019-06-27 09:00:00,129,47,0,0,23,35,23,11,268
2019-06-27 10:00:00,94,82,11,0,0,35,70,23,315
2019-06-27 11:00:00,165,306,23,0,35,59,118,11,717
2019-06-27 12:00:00,177,1262,23,0,11,70,424,82,2049
2019-06-27 13:00:00,460,991,70,0,35,118,224,35,1933
2019-06-27 14:00:00,247,590,94,0,47,82,283,47,1390
2019-06-27 15:00:00,306,1132,153,0,35,129,247,59,2061
2019-06-27 16:00:00,200,236,129,0,11,82,212,35,905
2019-06-27 17:00:00,165,141,236,0,23,59,129,70,823
2019-06-27 18:00:00,165,82,153,0,11,59,106,47,623
2019-06-27 19:00:00,118,59,165,0,0,118,11,82,553
2019-06-27 20:00:00,106,47,94,0,0,11,23,82,363
2019-06-27 21:00:00,59,82,59,0,0,0,59,47,306
2019-06-27 22:00:00,94,47,11,0,11,11,59,11,244
2019-06-27 23:00:00,35,11,0,0,0,11,35,11,103
2019-06-28 00:00:00,0,11,0,0,0,0,11,11,33
2019-06-28 01:00:00,0,0,0,0,0,0,0,0,0
2019-06-28 02:00:00,11,0,0,0,0,0,0,11,22
2019-06-28 03:00:00,0,11,0,0,0,0,0,0,11
2019-06-28 04:00:00,0,0,0,0,0,0,0,0,0
2019-06-28 05:00:00,0,0,0,0,0,0,0,0,0
2019-06-28 06:00:00,47,11,0,0,0,0,47,0,105
2019-06-28 07:00:00,11,0,0,0,0,11,23,23,68
2019-06-28 08:00:00,82,11,0,0,0,0,59,59,211
2019-06-28 09:00:00,106,47,11,0,11,11,59,11,256
2019-06-28 10:00:00,70,200,35,0,0,47,330,23,705
2019-06-28 11:00:00,141,1616,70,0,23,94,188,82,2214
2019-06-28 12:00:00,177,1073,59,0,0,271,389,70,2039
2019-06-28 13:00:00,118,991,35,0,11,188,354,70,1767
2019-06-28 14:00:00,188,920,82,0,70,106,306,35,1707
2019-06-28 15:00:00,354,991,23,0,23,177,200,82,1850
2019-06-28 16:00:00,200,283,23,0,35,23,177,47,788
2019-06-28 17:00:00,247,35,23,0,23,82,247,59,716
2019-06-28 18:00:00,141,59,47,0,0,59,236,47,589
2019-06-28 19:00:00,212,70,47,0,11,35,566,35,976
2019-06-28 20:00:00,47,70,47,0,11,35,23,35,268
2019-06-28 21:00:00,47,70,35,0,0,0,47,0,199
2019-06-28 22:00:00,47,47,0,0,11,35,82,11,233
2019-06-28 23:00:00,94,23,11,0,0,0,47,11,186
2019-06-29 00:00:00,11,11,0,0,0,0,0,11,33
2019-06-29 01:00:00,23,11,0,0,0,0,0,0,34
2019-06-29 02:00:00,23,0,0,0,0,0,0,0,23
2019-06-29 03:00:00,11,0,0,0,0,11,0,0,22
2019-06-29 04:00:00,0,0,0,0,0,0,11,11,22
2019-06-29 05:00:00,0,0,0,0,0,0,0,0,0
2019-06-29 06:00:00,94,0,0,0,0,0,11,0,105
2019-06-29 07:00:00,0,11,11,0,0,0,23,0,45
2019-06-29 08:00:00,23,11,0,0,0,23,35,0,92
2019-06-29 09:00:00,236,188,47,0,35,94,106,11,717
2019-06-29 10:00:00,94,70,23,0,35,153,212,23,610
2019-06-29 11:00:00,82,236,47,0,11,224,318,94,1012
2019-06-29 12:00:00,177,259,153,0,94,483,590,59,1815
2019-06-29 13:00:00,247,200,59,0,94,306,755,59,1720
2019-06-29 14:00:00,259,247,177,0,47,908,637,70,2345
2019-06-29 15:00:00,271,224,70,0,70,389,460,59,1543
2019-06-29 16:00:00,295,82,129,0,35,224,342,106,1213
2019-06-29 17:00:00,283,389,141,0,59,59,236,165,1332
2019-06-29 18:00:00,224,82,23,0,23,118,153,94,717
2019-06-29 19:00:00,118,59,35,0,23,59,82,59,435
2019-06-29 20:00:00,82,106,23,0,35,106,82,23,457
2019-06-29 21:00:00,23,0,47,0,35,23,70,23,221
2019-06-29 22:00:00,106,35,59,0,0,11,47,0,258
2019-06-29 23:00:00,47,35,11,0,0,23,47,0,163
2019-06-30 00:00:00,35,0,35,0,23,0,11,47,151
2019-06-30 01:00:00,35,0,11,0,0,0,35,23,104
2019-06-30 02:00:00,23,11,11,0,0,0,11,82,138
2019-06-30 03:00:00,11,11,0,0,0,0,11,0,33
2019-06-30 04:00:00,0,0,0,0,0,0,0,0,0
2019-06-30 05:00:00,0,0,0,0,0,0,11,0,11
2019-06-30 06:00:00,0,0,0,0,0,0,11,0,11
2019-06-30 07:00:00,0,0,35,0,0,0,11,0,46
2019-06-30 08:00:00,0,0,0,0,0,23,11,0,34
2019-06-30 09:00:00,47,35,0,0,0,23,47,0,152
2019-06-30 10:00:00,82,35,0,0,0,23,82,23,245
2019-06-30 11:00:00,94,106,23,0,35,82,141,11,492
2019-06-30 12:00:00,129,389,70,0,23,212,649,23,1495
2019-06-30 13:00:00,236,436,94,0,23,271,637,11,1708
2019-06-30 14:00:00,295,200,94,0,106,283,554,70,1602
2019-06-30 15:00:00,188,200,35,0,106,188,448,47,1212
2019-06-30 16:00:00,165,212,59,0,106,129,755,11,1437
2019-06-30 17:00:00,177,177,0,0,59,236,283,106,1038
2019-06-30 18:00:00,118,82,0,0,23,47,59,23,352
2019-06-30 19:00:00,70,141,0,0,11,59,82,35,398
2019-06-30 20:00:00,35,94,0,0,11,35,23,106,304
2019-06-30 21:00:00,82,82,0,0,0,59,70,70,363
2019-06-30 22:00:00,23,11,0,0,0,11,23,0,68
2019-06-30 23:00:00,0,0,0,0,11,0,0,0,11
2019-07-01 00:00:00,11,11,0,0,0,11,0,0,33
2019-07-01 01:00:00,0,11,0,0,0,11,0,0,22
2019-07-01 02:00:00,0,0,0,0,0,0,0,11,11
2019-07-01 03:00:00,23,0,0,0,0,0,11,0,34
2019-07-01 04:00:00,0,0,0,0,0,0,0,0,0
2019-07-01 05:00:00,35,0,0,0,0,11,0,0,46
2019-07-01 06:00:00,23,35,0,0,0,0,23,0,81
2019-07-01 07:00:00,35,0,0,0,0,0,11,23,69
2019-07-01 08:00:00,23,11,0,0,11,59,0,0,104
2019-07-01 09:00:00,82,0,0,0,0,23,23,23,151
2019-07-01 10:00:00,35,70,11,0,11,0,141,23,291
2019-07-01 11:00:00,106,283,47,0,0,35,200,11,682
2019-07-01 12:00:00,177,236,35,0,47,59,483,23,1060
2019-07-01 13:00:00,177,200,94,0,23,177,566,23,1260
2019-07-01 14:00:00,236,200,23,0,106,153,377,23,1118
2019-07-01 15:00:00,271,177,59,0,11,59,424,47,1048
2019-07-01 16:00:00,141,118,11,0,0,70,271,35,646
2019-07-01 17:00:00,82,106,35,0,0,23,177,23,446
2019-07-01 18:00:00,59,94,0,0,0,35,82,23,293
2019-07-01 19:00:00,59,82,0,0,0,94,82,70,387
2019-07-01 20:00:00,47,23,0,0,0,11,59,35,175
2019-07-01 21:00:00,35,23,0,0,0,23,70,0,151
2019-07-01 22:00:00,11,35,0,0,0,23,0,23,92
2019-07-01 23:00:00,11,23,0,0,0,0,11,0,45
2019-07-02 00:00:00,11,0,0,0,0,0,0,11,22
2019-07-02 01:00:00,0,0,0,0,0,11,0,0,11
2019-07-02 02:00:00,0,0,0,0,0,0,0,0,0
2019-07-02 03:00:00,0,11,0,0,0,0,0,0,11
2019-07-02 04:00:00,0,0,0,0,0,0,0,0,0
2019-07-02 05:00:00,23,11,0,0,0,0,11,0,45
2019-07-02 06:00:00,47,0,0,0,0,0,35,0,82
2019-07-02 07:00:00,35,11,0,0,0,11,47,23,127
2019-07-02 08:00:00,0,0,0,0,11,11,23,0,45
2019-07-02 09:00:00,70,94,23,0,0,23,35,23,268
2019-07-02 10:00:00,59,59,11,0,23,23,106,11,292
2019-07-02 11:00:00,106,141,35,0,177,47,247,35,788
2019-07-02 12:00:00,259,472,11,0,165,165,1156,23,2251
2019-07-02 13:00:00,224,436,23,0,94,188,696,23,1684
2019-07-02 14:00:00,318,318,11,0,129,141,342,82,1341
2019-07-02 15:00:00,271,283,23,0,106,188,330,23,1224
2019-07-02 16:00:00,306,106,11,0,11,129,318,47,928
2019-07-02 17:00:00,165,118,23,0,23,141,141,23,634
2019-07-02 18:00:00,129,94,0,0,11,70,165,0,469
2019-07-02 19:00:00,165,11,23,0,0,11,118,0,328
2019-07-02 20:00:00,129,59,11,0,23,59,82,11,374
2019-07-02 21:00:00,94,70,35,0,0,23,129,0,351
2019-07-02 22:00:00,23,11,0,0,0,0,94,0,128
2019-07-02 23:00:00,23,0,0,0,0,0,59,23,105
2019-07-03 00:00:00,0,23,0,0,0,0,23,0,46
2019-07-03 01:00:00,0,11,0,0,0,0,23,0,34
2019-07-03 02:00:00,0,23,0,0,0,0,23,0,46
2019-07-03 03:00:00,0,35,0,0,0,0,23,0,58
2019-07-03 04:00:00,0,35,0,0,0,0,0,0,35
2019-07-03 05:00:00,0,23,0,0,0,0,0,0,23
2019-07-03 06:00:00,0,59,0,0,0,0,23,23,105
2019-07-03 07:00:00,35,23,0,0,11,11,11,23,114
2019-07-03 08:00:00,59,59,11,0,11,0,70,11,221
2019-07-03 09:00:00,70,82,23,0,0,35,141,47,398
2019-07-03 10:00:00,129,118,0,0,11,23,153,0,434
2019-07-03 11:00:00,94,224,35,0,59,106,342,23,883
2019-07-03 12:00:00,200,165,35,0,23,70,472,11,976
2019-07-03 13:00:00,330,283,70,0,11,129,566,35,1424
2019-07-03 14:00:00,247,200,47,0,59,82,649,11,1295
2019-07-03 15:00:00,188,247,35,0,82,106,424,23,1105
2019-07-03 16:00:00,212,236,11,0,11,94,377,35,976
2019-07-03 17:00:00,141,70,23,0,35,70,129,23,491
2019-07-03 18:00:00,94,94,23,0,23,0,59,23,316
2019-07-03 19:00:00,59,82,59,0,0,47,165,0,412
2019-07-03 20:00:00,106,141,0,0,35,35,82,59,458
2019-07-03 21:00:00,35,11,35,0,11,35,94,23,244
2019-07-03 22:00:00,0,35,0,0,0,11,82,0,128
2019-07-03 23:00:00,35,0,0,0,11,0,47,35,128
2019-07-04 00:00:00,0,11,0,0,0,0,82,0,93
2019-07-04 01:00:00,0,0,0,0,0,0,94,11,105
2019-07-04 02:00:00,0,0,0,0,0,0,11,0,11
2019-07-04 03:00:00,11,0,0,0,0,0,0,0,11
2019-07-04 04:00:00,11,0,0,0,0,0,23,0,34
2019-07-04 05:00:00,23,11,0,0,0,0,11,0,45
2019-07-04 06:00:00,23,11,0,0,0,0,82,0,116
2019-07-04 07:00:00,106,0,0,0,0,11,118,35,270
2019-07-04 08:00:00,47,0,47,0,0,11,82,23,210
2019-07-04 09:00:00,106,11,59,0,0,0,59,0,235
2019-07-04 10:00:00,94,47,11,0,11,23,118,11,315
2019-07-04 11:00:00,94,129,23,0,23,59,283,0,611
2019-07-04 12:00:00,200,177,23,0,59,70,401,0,930
2019-07-04 13:00:00,129,177,23,0,47,165,424,0,965
2019-07-04 14:00:00,247,424,35,0,47,165,991,23,1932
2019-07-04 15:00:00,354,660,129,0,59,153,625,11,1991
2019-07-04 16:00:00,188,200,59,0,35,106,613,23,1224
2019-07-04 17:00:00,188,141,94,0,23,118,141,0,705
2019-07-04 18:00:00,47,141,35,0,0,47,82,70,422
2019-07-04 19:00:00,247,35,70,0,0,70,82,59,563
2019-07-04 20:00:00,23,70,23,0,47,47,82,0,292
2019-07-04 21:00:00,59,70,11,0,23,11,70,23,267
2019-07-04 22:00:00,59,59,11,0,0,0,47,11,187
2019-07-04 23:00:00,23,0,35,0,0,0,11,23,92
2019-07-05 00:00:00,0,23,0,0,0,0,35,0,58
2019-07-05 01:00:00,0,0,0,0,23,23,11,0,57
2019-07-05 02:00:00,0,0,0,0,0,0,11,0,11
2019-07-05 03:00:00,0,0,0,0,0,0,35,0,35
2019-07-05 04:00:00,0,0,0,0,0,0,23,0,23
2019-07-05 05:00:00,23,0,0,0,0,0,11,11,45
2019-07-05 06:00:00,11,11,0,0,0,0,35,0,57
2019-07-05 07:00:00,47,23,0,0,0,11,59,11,151
2019-07-05 08:00:00,70,11,11,0,0,23,59,47,221
2019-07-05 09:00:00,106,11,0,0,0,11,70,0,198
2019-07-05 10:00:00,82,153,23,0,23,70,141,11,503
2019-07-05 11:00:00,259,259,59,0,47,129,318,11,1082
2019-07-05 12:00:00,200,236,23,0,47,94,731,23,1354
2019-07-05 13:00:00,165,200,59,0,70,94,519,23,1130
2019-07-05 14:00:00,224,413,129,0,59,141,554,0,1520
2019-07-05 15:00:00,295,153,59,0,118,94,649,82,1450
2019-07-05 16:00:00,212,200,70,0,11,35,413,11,952
2019-07-05 17:00:00,247,82,118,0,47,59,365,23,941
2019-07-05 18:00:00,519,59,0,0,11,70,212,35,906
2019-07-05 19:00:00,129,82,94,0,47,59,188,23,622
2019-07-05 20:00:00,141,70,23,0,11,59,70,23,397
2019-07-05 21:00:00,70,0,0,0,0,47,70,35,222
2019-07-05 22:00:00,70,11,11,0,0,59,0,59,210
2019-07-05 23:00:00,47,0,11,0,0,23,0,0,81
2019-07-06 00:00:00,0,0,0,0,0,11,11,0,22
2019-07-06 01:00:00,11,0,0,0,0,23,0,0,34
2019-07-06 02:00:00,47,11,0,0,0,0,11,11,80
2019-07-06 03:00:00,212,0,0,0,0,11,0,11,234
2019-07-06 04:00:00,0,0,0,0,0,0,0,0,0
2019-07-06 05:00:00,0,0,0,0,0,0,0,0,0
2019-07-06 06:00:00,0,0,0,0,0,0,11,0,11
2019-07-06 07:00:00,0,0,23,0,0,0,0,0,23
2019-07-06 08:00:00,0,0,23,0,0,0,23,0,46
2019-07-06 09:00:00,11,23,11,0,0,0,70,0,115
2019-07-06 10:00:00,35,141,11,0,0,0,200,11,398
2019-07-06 11:00:00,212,259,23,0,82,259,590,35,1460
2019-07-06 12:00:00,236,424,70,0,295,283,814,11,2133
2019-07-06 13:00:00,283,401,35,0,82,259,944,47,2051
2019-07-06 14:00:00,318,306,118,0,118,354,790,23,2027
2019-07-06 15:00:00,247,271,82,0,118,306,531,0,1555
2019-07-06 16:00:00,141,118,118,0,35,141,413,23,989
2019-07-06 17:00:00,129,35,35,0,11,82,177,0,469
2019-07-06 18:00:00,165,70,35,0,23,70,295,0,658
2019-07-06 19:00:00,94,35,47,0,23,0,94,35,328
2019-07-06 20:00:00,23,94,23,0,0,23,129,11,303
2019-07-06 21:00:00,59,141,11,0,0,47,11,11,280
2019-07-06 22:00:00,23,11,0,0,11,11,106,11,173
2019-07-06 23:00:00,0,0,11,0,0,0,70,11,92
2019-07-07 00:00:00,0,0,23,0,0,0,70,0,93
2019-07-07 01:00:00,0,0,0,0,0,0,23,11,34
2019-07-07 02:00:00,0,0,0,0,0,0,35,23,58
2019-07-07 03:00:00,0,0,11,0,0,0,35,23,69
2019-07-07 04:00:00,0,0,0,0,0,11,23,0,34
2019-07-07 05:00:00,0,0,0,0,0,0,11,0,11
2019-07-07 06:00:00,0,0,0,0,0,0,11,11,22
2019-07-07 07:00:00,0,0,0,0,0,0,59,0,59
2019-07-07 08:00:00,0,0,23,0,0,11,70,0,104
2019-07-07 09:00:00,0,0,11,0,0,23,70,0,104
2019-07-07 10:00:00,0,0,0,0,0,118,165,11,294
2019-07-07 11:00:00,0,0,23,0,0,118,472,11,624
2019-07-07 12:00:00,0,0,82,0,0,224,1451,94,1851
2019-07-07 13:00:00,0,0,106,0,0,342,873,70,1391
2019-07-07 14:00:00,0,0,94,0,0,365,1144,94,1697
2019-07-07 15:00:00,0,0,94,0,0,129,542,11,776
2019-07-07 16:00:00,0,0,82,0,0,236,483,35,836
2019-07-07 17:00:00,0,0,59,0,0,177,283,23,542
2019-07-07 18:00:00,0,0,11,0,0,94,106,0,211
2019-07-07 19:00:00,0,0,23,0,0,70,106,11,210
2019-07-07 20:00:00,0,0,11,0,0,35,94,11,151
2019-07-07 21:00:00,0,0,35,0,0,35,35,11,116
2019-07-07 22:00:00,0,0,0,0,0,0,23,0,23
2019-07-07 23:00:00,11,0,0,0,0,0,0,11,22
2019-07-08 00:00:00,11,0,0,0,0,0,11,0,22
2019-07-08 01:00:00,0,0,0,0,0,0,0,0,0
2019-07-08 02:00:00,11,0,0,0,0,0,0,0,11
2019-07-08 03:00:00,0,0,0,0,0,0,0,59,59
2019-07-08 04:00:00,0,0,0,0,0,0,0,0,0
2019-07-08 05:00:00,0,11,0,0,0,11,0,0,22
2019-07-08 06:00:00,11,11,0,0,0,0,11,0,33
2019-07-08 07:00:00,70,35,0,0,0,23,0,47,175
2019-07-08 08:00:00,11,35,11,0,11,35,23,0,126
2019-07-08 09:00:00,94,59,23,0,11,35,94,11,327
2019-07-08 10:00:00,153,59,47,0,11,47,153,0,470
2019-07-08 11:00:00,59,165,82,0,413,94,177,23,1013
2019-07-08 12:00:00,236,271,23,0,413,153,472,23,1591
2019-07-08 13:00:00,118,306,11,0,47,94,531,23,1130
2019-07-08 14:00:00,188,283,11,23,70,106,601,23,1305
2019-07-08 15:00:00,212,295,35,82,59,177,613,59,1532
2019-07-08 16:00:00,177,200,11,0,11,82,389,11,881
2019-07-08 17:00:00,94,94,35,0,11,106,259,23,622
2019-07-08 18:00:00,82,153,0,0,0,165,200,47,647
2019-07-08 19:00:00,153,118,47,0,11,82,94,0,505
2019-07-08 20:00:00,153,153,0,0,23,47,165,23,564
2019-07-08 21:00:00,23,82,11,0,11,59,70,23,279
2019-07-08 22:00:00,23,82,11,0,23,47,70,11,267
2019-07-08 23:00:00,23,23,0,0,0,0,47,0,93
2019-07-09 00:00:00,11,0,0,0,0,0,11,0,22
2019-07-09 01:00:00,0,0,0,0,0,0,0,0,0
2019-07-09 02:00:00,0,0,0,0,0,0,11,0,11
2019-07-09 03:00:00,0,0,0,0,0,0,11,0,11
2019-07-09 04:00:00,0,11,0,0,0,0,0,0,11
2019-07-09 05:00:00,11,0,0,0,0,0,0,11,22
2019-07-09 06:00:00,23,35,0,0,0,0,35,0,93
2019-07-09 07:00:00,11,0,0,0,0,11,82,23,127
2019-07-09 08:00:00,23,59,0,0,0,11,59,0,152
2019-07-09 09:00:00,82,47,0,0,11,35,70,35,280
2019-07-09 10:00:00,94,59,23,23,23,23,188,11,444
2019-07-09 11:00:00,342,424,23,94,35,153,401,35,1507
2019-07-09 12:00:00,283,448,70,47,94,153,578,11,1684
2019-07-09 13:00:00,295,354,23,0,70,306,1286,0,2334
2019-07-09 14:00:00,295,472,23,0,70,153,861,47,1921
2019-07-09 15:00:00,247,460,23,0,47,247,601,23,1648
2019-07-09 16:00:00,188,236,82,0,59,94,542,23,1224
2019-07-09 17:00:00,259,224,106,0,70,129,318,70,1176
2019-07-09 18:00:00,247,118,118,0,47,59,153,47,789
2019-07-09 19:00:00,118,94,47,0,23,35,129,23,469
2019-07-09 20:00:00,141,70,70,0,11,11,118,118,539
2019-07-09 21:00:00,47,106,11,0,0,0,141,23,328
2019-07-09 22:00:00,200,23,11,0,11,11,59,11,326
2019-07-09 23:00:00,0,47,0,0,0,0,11,11,69
2019-07-10 00:00:00,0,11,11,0,0,0,0,0,22
2019-07-10 01:00:00,0,0,0,0,0,0,0,0,0
2019-07-10 02:00:00,0,0,0,0,0,0,0,0,0
2019-07-10 03:00:00,0,0,0,0,0,0,0,0,0
2019-07-10 04:00:00,11,0,0,0,0,0,0,0,11
2019-07-10 05:00:00,0,0,0,0,0,0,0,0,0
2019-07-10 06:00:00,11,11,0,0,0,0,11,11,44
2019-07-10 07:00:00,35,11,23,0,0,0,23,0,92
2019-07-10 08:00:00,11,82,35,0,0,11,35,23,197
2019-07-10 09:00:00,118,82,23,0,23,47,70,47,410
2019-07-10 10:00:00,283,70,35,0,35,118,141,23,705
2019-07-10 11:00:00,200,424,118,0,35,106,590,70,1543
2019-07-10 12:00:00,200,247,82,0,59,153,472,129,1342
2019-07-10 13:00:00,330,472,106,0,23,259,660,129,1979
2019-07-10 14:00:00,200,224,59,0,70,177,472,82,1284
2019-07-10 15:00:00,283,306,70,0,59,212,613,94,1637
2019-07-10 16:00:00,177,306,129,0,35,177,507,106,1437
2019-07-10 17:00:00,365,236,106,0,70,259,330,47,1413
2019-07-10 18:00:00,177,247,94,0,11,106,283,59,977
2019-07-10 19:00:00,224,82,70,0,70,1180,165,47,1838
2019-07-10 20:00:00,200,0,82,0,59,165,153,70,729
2019-07-10 21:00:00,247,59,70,0,59,153,82,59,729
2019-07-10 22:00:00,11,94,11,0,23,70,59,0,268
2019-07-10 23:00:00,94,59,0,0,0,11,59,106,329
2019-07-11 00:00:00,0,23,11,0,0,11,11,59,115
2019-07-11 01:00:00,11,0,11,0,0,0,0,47,69
2019-07-11 02:00:00,0,0,11,0,0,0,11,11,33
2019-07-11 03:00:00,0,0,0,0,0,0,0,0,0
2019-07-11 04:00:00,0,0,23,0,0,0,0,0,23
2019-07-11 05:00:00,11,0,11,0,0,0,11,0,33
2019-07-11 06:00:00,47,23,0,0,0,0,23,0,93
2019-07-11 07:00:00,70,23,23,0,0,0,0,59,175
2019-07-11 08:00:00,82,47,82,0,11,35,59,23,339
2019-07-11 09:00:00,153,177,47,0,0,35,118,23,553
2019-07-11 10:00:00,306,212,70,0,11,94,153,59,905
2019-07-11 11:00:00,590,153,236,0,0,118,330,212,1639
2019-07-11 12:00:00,696,590,365,0,70,247,672,118,2758
2019-07-11 13:00:00,1050,637,649,0,247,778,1132,188,4681
2019-07-11 14:00:00,885,507,1262,0,200,507,979,212,4552
2019-07-11 15:00:00,767,861,672,0,70,188,1805,118,4481
2019-07-11 16:00:00,896,247,1132,0,47,247,802,129,3500
2019-07-11 17:00:00,1262,306,377,0,23,177,566,129,2840
2019-07-11 18:00:00,660,436,424,0,23,94,389,153,2179
2019-07-11 19:00:00,554,247,295,0,59,129,271,283,1838
2019-07-11 20:00:00,436,224,436,0,47,47,153,70,1413
2019-07-11 21:00:00,295,106,507,0,70,47,153,94,1272
2019-07-11 22:00:00,389,94,483,0,0,94,106,59,1225
2019-07-11 23:00:00,153,59,82,0,0,35,200,59,588
2019-07-12 00:00:00,11,23,35,0,0,11,47,0,127
2019-07-12 01:00:00,47,0,0,0,0,11,0,11,69
2019-07-12 02:00:00,11,0,0,0,0,0,23,0,34
2019-07-12 03:00:00,0,0,0,0,0,0,11,0,11
2019-07-12 04:00:00,0,0,0,0,0,0,0,0,0
2019-07-12 05:00:00,11,0,0,0,0,0,11,0,22
2019-07-12 06:00:00,11,35,0,0,11,11,47,23,138
2019-07-12 07:00:00,70,0,11,0,0,11,47,59,198
2019-07-12 08:00:00,118,82,59,0,0,11,82,35,387
2019-07-12 09:00:00,413,82,23,0,23,11,94,35,681
2019-07-12 10:00:00,0,271,82,0,23,106,259,47,788
2019-07-12 11:00:00,436,259,318,0,70,106,354,106,1649
2019-07-12 12:00:00,696,342,436,0,82,236,837,165,2794
2019-07-12 13:00:00,542,472,601,0,70,413,1180,200,3478
2019-07-12 14:00:00,0,554,542,0,141,365,932,188,2722
2019-07-12 15:00:00,0,1132,566,0,47,271,991,118,3125
2019-07-12 16:00:00,0,436,460,0,177,165,790,188,2216
2019-07-12 17:00:00,0,436,306,0,106,224,601,165,1838
2019-07-12 18:00:00,0,413,177,0,141,188,578,129,1626
2019-07-12 19:00:00,0,271,200,0,23,224,837,177,1732
2019-07-12 20:00:00,0,342,141,0,35,177,684,118,1497
2019-07-12 21:00:00,0,177,47,0,59,129,212,23,647
2019-07-12 22:00:00,0,82,59,0,11,70,177,59,458
2019-07-12 23:00:00,448,0,47,0,35,70,165,59,824
2019-07-13 00:00:00,118,0,35,0,11,47,35,59,305
2019-07-13 01:00:00,47,0,11,0,11,11,11,11,102
2019-07-13 02:00:00,11,0,11,0,11,0,0,0,33
2019-07-13 03:00:00,11,0,0,0,0,0,23,0,34
2019-07-13 04:00:00,11,0,0,0,0,0,11,0,22
2019-07-13 05:00:00,0,0,0,0,0,0,11,0,11
2019-07-13 06:00:00,11,0,0,0,0,0,11,0,22
2019-07-13 07:00:00,23,0,0,0,0,23,11,0,57
2019-07-13 08:00:00,59,0,23,0,0,0,11,11,104
2019-07-13 09:00:00,165,0,94,0,0,35,177,23,494
2019-07-13 10:00:00,365,0,94,0,0,11,247,23,740
2019-07-13 11:00:00,519,0,318,0,82,177,413,94,1603
2019-07-13 12:00:00,873,0,731,0,129,389,1132,141,3395
2019-07-13 13:00:00,1050,0,684,0,153,495,1722,200,4304
2019-07-13 14:00:00,0,0,719,0,236,767,1534,94,3350
2019-07-13 15:00:00,0,0,1050,0,247,413,1392,224,3326
2019-07-13 16:00:00,0,0,1014,0,212,531,1333,141,3231
2019-07-13 17:00:00,778,0,708,0,188,330,896,141,3041
2019-07-13 18:00:00,1321,0,483,0,106,306,790,129,3135
2019-07-13 19:00:00,637,0,495,0,23,271,436,59,1921
2019-07-13 20:00:00,542,0,719,0,82,295,377,94,2109
2019-07-13 21:00:00,507,0,259,0,70,283,236,35,1390
2019-07-13 22:00:00,684,0,283,0,118,188,224,23,1520
2019-07-13 23:00:00,436,129,460,0,70,342,106,70,1613
